AQ1,AQ2,AQ3,AQ4,AOT1,AOT2,AT,HQ1,HQ2,HQ3,HQ4,HOT1,HOT2,HT
29,34,25,29,0,0,117,24,39,35,28,0,0,126
22,30,19,38,0,0,109,25,34,32,32,0,0,123
28,27,28,26,0,0,109,17,40,34,22,0,0,113
36,24,27,27,0,0,114,25,27,25,30,0,0,107
20,30,30,27,0,0,107,26,33,25,33,0,0,117
32,26,40,32,0,0,130,14,36,28,30,0,0,108
23,23,33,29,4,0,112,25,36,24,23,7,0,115
28,31,37,20,0,0,116,33,26,27,22,0,0,108
22,35,27,21,0,0,105,28,23,25,32,0,0,108
22,30,35,21,0,0,108,35,30,22,28,0,0,115
38,30,30,31,0,0,129,22,25,28,27,0,0,102
30,23,27,22,0,0,102,37,38,19,29,0,0,123
32,30,19,24,0,0,105,24,21,31,31,0,0,107
32,19,33,31,0,0,115,23,32,29,24,0,0,108
30,17,26,17,0,0,90,24,21,18,25,0,0,88
35,21,29,18,0,0,103,23,33,21,20,0,0,97
35,26,32,31,0,0,124,24,27,34,27,0,0,112
36,34,32,35,0,0,137,26,29,30,49,0,0,134
30,20,24,26,0,0,100,26,30,21,25,0,0,102
27,27,27,17,0,0,98,19,31,30,28,0,0,108
24,28,27,26,0,0,105,28,21,29,31,0,0,109
30,29,30,22,0,0,111,22,29,26,27,0,0,104
20,32,29,25,0,0,106,30,42,31,27,0,0,130
26,36,33,34,0,0,129,32,38,30,22,0,0,122
26,29,33,32,12,0,132,41,23,23,33,6,0,126
40,30,28,30,0,0,128,34,18,36,35,0,0,123
28,25,26,23,9,0,111,25,22,28,27,11,0,113
19,35,31,29,0,0,114,25,26,26,28,0,0,105
35,21,23,36,0,0,115,25,27,36,36,0,0,124
36,32,31,27,0,0,126,33,35,26,26,0,0,120
34,36,23,35,0,0,128,25,29,25,17,0,0,96
33,17,33,26,0,0,109,38,33,21,20,0,0,112
23,25,31,26,0,0,105,41,26,31,27,0,0,125
17,19,35,25,0,0,96,39,25,35,38,0,0,137
29,26,30,32,0,0,117,28,27,33,34,0,0,122
29,23,34,25,0,0,111,26,29,25,29,0,0,109
32,23,23,28,0,0,106,24,24,35,21,0,0,104
22,37,45,22,0,0,126,30,25,29,25,0,0,109
31,20,25,27,4,0,107,30,27,26,20,14,0,117
26,37,30,17,12,0,122,24,29,31,26,11,0,121
31,22,29,34,0,0,116,18,26,30,32,0,0,106
36,35,23,31,0,0,125,39,50,24,17,0,0,130
33,28,25,26,0,0,112,18,23,31,23,0,0,95
23,23,30,30,0,0,106,33,31,26,30,0,0,120
27,21,23,27,0,0,98,23,20,33,14,0,0,90
28,31,23,20,0,0,102,34,31,31,19,0,0,115
39,15,25,23,0,0,102,30,35,35,20,0,0,120
18,27,28,35,0,0,108,21,30,26,37,0,0,114
34,35,28,27,0,0,124,39,25,45,25,0,0,134
39,28,36,12,0,0,115,28,29,14,35,0,0,106
31,30,25,24,0,0,110,23,32,44,36,0,0,135
25,24,26,24,0,0,99,28,28,29,35,0,0,120
31,33,25,22,0,0,111,40,26,21,26,0,0,113
18,25,25,26,0,0,94,23,26,35,24,0,0,108
29,37,20,19,0,0,105,37,35,33,29,0,0,134
24,26,19,23,0,0,92,30,24,19,30,0,0,103
36,26,27,29,0,0,118,32,29,28,24,0,0,113
20,35,21,23,0,0,99,25,18,35,32,0,0,110
30,32,28,32,9,0,131,32,37,29,24,12,0,134
27,26,26,30,0,0,109,35,28,26,30,0,0,119
27,30,36,16,0,0,109,38,38,27,21,0,0,124
28,25,41,28,0,0,122,39,29,34,32,0,0,134
21,28,26,26,0,0,101,22,39,28,20,0,0,109
22,32,17,28,0,0,99,26,28,32,24,0,0,110
28,33,33,25,0,0,119,31,25,25,17,0,0,98
30,31,29,22,17,0,129,23,36,25,28,13,0,125
24,36,27,23,0,0,110,34,19,36,29,0,0,118
30,29,28,23,0,0,110,31,32,29,31,0,0,123
32,31,31,31,0,0,125,28,28,27,27,0,0,110
35,34,37,30,0,0,136,29,38,27,18,0,0,112
19,11,23,40,0,0,93,22,29,31,31,0,0,113
33,29,33,19,18,0,132,34,41,24,15,9,0,123
28,37,16,31,0,0,112,26,22,22,20,0,0,90
36,39,26,26,0,0,127,28,32,30,27,0,0,117
24,29,32,23,0,0,108,26,33,37,23,0,0,119
25,27,23,27,0,0,102,28,24,26,33,0,0,111
29,31,34,30,0,0,124,36,26,32,35,0,0,129
25,25,28,23,0,0,101,35,28,26,28,0,0,117
27,25,31,28,0,0,111,21,36,36,31,0,0,124
23,35,24,29,0,0,111,32,37,27,29,0,0,125
23,26,33,31,0,0,113,32,39,19,29,0,0,119
23,27,33,24,6,0,113,34,28,18,27,13,0,120
26,37,29,33,0,0,125,26,36,28,26,0,0,116
37,27,26,24,0,0,114,22,34,31,22,0,0,109
30,21,33,31,0,0,115,32,27,32,32,0,0,123
27,19,26,27,18,0,117,25,26,20,28,12,0,111
30,24,37,32,0,0,123,24,38,33,29,0,0,124
18,34,26,34,0,0,112,25,27,15,24,0,0,91
15,32,21,26,0,0,94,34,24,29,25,0,0,112
30,29,34,15,0,0,108,35,27,22,37,0,0,121
37,18,36,23,0,0,114,29,34,37,28,0,0,128
23,24,23,28,0,0,98,26,31,28,22,0,0,107
34,26,23,22,0,0,105,29,31,28,26,0,0,114
24,32,30,23,0,0,109,29,36,25,34,0,0,124
31,20,34,25,0,0,110,26,29,38,28,0,0,121
24,28,37,26,0,0,115,34,33,18,23,0,0,108
30,22,34,32,0,0,118,28,24,21,38,0,0,111
18,36,31,24,0,0,109,33,28,31,24,0,0,116
28,25,27,29,0,0,109,34,30,31,44,0,0,139
23,29,25,31,0,0,108,34,26,28,22,0,0,110
26,18,30,31,0,0,105,23,38,36,24,0,0,121
23,29,24,17,0,0,93,30,21,22,22,0,0,95
25,27,25,31,0,0,108,27,31,22,19,0,0,99
24,32,38,15,0,0,109,33,25,28,30,0,0,116
32,34,22,20,0,0,108,33,30,22,31,0,0,116
20,27,26,34,0,0,107,24,30,30,32,0,0,116
31,26,34,30,0,0,121,25,26,39,21,0,0,111
27,29,20,31,6,0,113,35,15,33,24,7,0,114
32,19,25,31,0,0,107,33,20,24,33,0,0,110
21,36,32,23,0,0,112,32,33,10,24,0,0,99
26,26,18,18,0,0,88,27,34,23,22,0,0,106
34,22,30,23,0,0,109,24,29,26,22,0,0,101
26,21,21,23,0,0,91,31,25,29,31,0,0,116
32,32,40,39,0,0,143,31,18,21,30,0,0,100
35,15,28,22,0,0,100,23,24,27,29,0,0,103
30,22,26,33,0,0,111,23,22,27,34,0,0,106
27,17,35,32,6,0,117,23,33,26,29,9,0,120
30,35,33,31,0,0,129,30,23,43,34,0,0,130
42,29,22,29,0,0,122,29,28,38,15,0,0,110
24,33,33,22,0,0,112,21,18,29,20,0,0,88
29,21,27,22,0,0,99,28,34,18,21,0,0,101
21,37,16,32,0,0,106,22,31,30,21,0,0,104
38,31,27,32,0,0,128,28,29,13,16,0,0,86
31,26,30,32,0,0,119,26,37,30,30,0,0,123
24,23,22,30,0,0,99,41,30,33,26,0,0,130
28,26,28,31,0,0,113,18,40,28,20,0,0,106
29,28,24,29,0,0,110,31,31,34,15,0,0,111
27,27,25,26,0,0,105,26,35,27,26,0,0,114
34,27,34,20,0,0,115,26,28,30,18,0,0,102
25,34,27,22,0,0,108,28,21,31,26,0,0,106
40,35,25,30,0,0,130,34,28,33,21,0,0,116
25,22,36,23,20,0,126,33,32,12,29,17,0,123
30,22,17,29,0,0,98,21,23,26,24,0,0,94
28,24,33,24,12,0,121,29,31,28,21,15,0,124
32,35,34,32,0,0,133,29,37,30,22,0,0,118
34,19,25,16,0,0,94,34,33,26,15,0,0,108
34,15,34,34,0,0,117,40,28,35,26,0,0,129
27,24,25,25,0,0,101,40,30,29,27,0,0,126
26,14,21,21,0,0,82,35,26,23,18,0,0,102
30,28,29,27,0,0,114,36,28,16,20,0,0,100
25,18,31,23,0,0,97,24,33,24,22,0,0,103
30,19,33,22,0,0,104,21,34,28,30,0,0,113
29,34,21,26,0,0,110,29,27,29,17,0,0,102
26,20,30,32,0,0,108,18,30,24,28,0,0,100
33,38,29,34,0,0,134,30,35,23,39,0,0,127
33,30,22,18,0,0,103,28,20,36,28,0,0,112
30,25,36,31,0,0,122,32,26,42,29,0,0,129
20,27,23,18,0,0,88,33,23,19,25,0,0,100
36,22,22,18,0,0,98,25,27,37,28,0,0,117
28,25,20,37,0,0,110,28,32,21,26,0,0,107
27,26,17,27,0,0,97,30,28,28,25,0,0,111
28,37,19,25,0,0,109,34,20,31,21,0,0,106
38,38,27,17,0,0,120,29,23,28,27,0,0,107
28,37,29,21,0,0,115,28,34,27,20,0,0,109
34,16,23,21,0,0,94,29,24,19,24,0,0,96
31,36,21,25,0,0,113,29,26,24,37,0,0,116
34,37,27,18,0,0,116,42,34,39,24,0,0,139
37,27,23,30,0,0,117,31,33,24,31,0,0,119
28,26,20,13,0,0,87,24,26,23,21,0,0,94
25,33,28,19,0,0,105,30,23,26,16,0,0,95
35,21,33,33,0,0,122,27,43,25,24,0,0,119
26,37,22,40,0,0,125,22,32,36,29,0,0,119
21,28,30,33,0,0,112,29,34,32,33,0,0,128
22,22,27,14,0,0,85,38,31,23,20,0,0,112
37,17,28,27,0,0,109,29,28,29,30,0,0,116
22,30,27,36,0,0,115,22,28,32,29,0,0,111
39,30,35,25,0,0,129,25,26,31,35,0,0,117
27,28,29,35,7,10,136,27,28,32,32,7,6,132
38,28,23,23,12,0,124,32,27,35,18,10,0,122
21,31,23,26,0,0,101,38,16,33,27,0,0,114
29,29,35,27,0,0,120,34,35,28,30,0,0,127
34,27,22,22,0,0,105,28,30,29,26,0,0,113
20,22,24,29,0,0,95,29,17,34,24,0,0,104
27,23,23,31,8,0,112,32,26,27,19,13,0,117
27,24,27,28,0,0,106,27,30,17,21,0,0,95
25,32,34,21,0,0,112,33,33,31,34,0,0,131
23,29,22,23,0,0,97,30,28,29,27,0,0,114
26,32,22,32,0,0,112,30,38,26,27,0,0,121
24,32,29,28,0,0,113,29,41,36,26,0,0,132
27,19,30,17,0,0,93,31,23,29,28,0,0,111
30,33,21,19,0,0,103,33,39,24,18,0,0,114
25,27,25,24,0,0,101,25,23,26,32,0,0,106
23,33,31,33,0,0,120,23,37,28,26,0,0,114
24,30,21,35,0,0,110,19,31,21,24,0,0,95
30,25,29,28,0,0,112,28,33,31,29,0,0,121
30,25,34,28,0,0,117,29,28,24,27,0,0,108
26,39,25,14,0,0,104,28,24,30,36,0,0,118
24,27,33,25,0,0,109,37,30,32,22,0,0,121
33,26,25,31,0,0,115,34,23,45,30,0,0,132
25,32,31,24,0,0,112,35,24,26,32,0,0,117
26,24,37,19,0,0,106,34,29,23,33,0,0,119
36,43,43,23,0,0,145,48,25,33,29,0,0,135
40,27,37,25,0,0,129,20,30,34,40,0,0,124
19,32,23,18,0,0,92,23,32,27,20,0,0,102
30,27,21,20,0,0,98,26,25,27,27,0,0,105
32,30,35,29,0,0,126,20,27,29,27,0,0,103
39,23,29,24,0,0,115,26,38,34,24,0,0,122
22,24,31,26,0,0,103,26,29,25,36,0,0,116
27,31,30,27,0,0,115,23,28,26,34,0,0,111
31,27,26,28,0,0,112,23,22,24,36,0,0,105
35,34,27,26,0,0,122,32,30,27,37,0,0,126
31,26,34,21,0,0,112,35,23,26,29,0,0,113
31,27,31,33,0,0,122,23,23,32,28,0,0,106
29,34,31,27,0,0,121,24,26,30,26,0,0,106
26,19,23,27,0,0,95,33,28,38,33,0,0,132
35,25,27,15,0,0,102,32,27,30,24,0,0,113
15,17,33,36,0,0,101,30,24,15,34,0,0,103
23,38,22,35,0,0,118,27,31,27,26,0,0,111
29,27,33,21,0,0,110,30,32,31,24,0,0,117
30,24,28,39,0,0,121,36,37,42,38,0,0,153
27,33,30,35,0,0,125,27,36,27,23,0,0,113
42,32,24,28,0,0,126,24,25,31,28,0,0,108
29,25,35,32,0,0,121,37,30,20,33,0,0,120
30,32,35,29,0,0,126,18,35,25,23,0,0,101
31,29,19,25,0,0,104,27,27,30,28,0,0,112
37,23,18,20,0,0,98,34,27,34,18,0,0,113
28,25,25,32,0,0,110,32,26,37,29,0,0,124
31,26,19,25,0,0,101,28,23,23,18,0,0,92
30,25,25,26,0,0,106,27,27,30,19,0,0,103
33,32,24,30,0,0,119,36,36,31,27,0,0,130
28,29,28,24,0,0,109,28,33,21,25,0,0,107
28,28,26,30,0,0,112,37,26,26,41,0,0,130
23,27,17,24,0,0,91,15,27,26,28,0,0,96
31,38,19,16,2,0,106,33,24,24,23,3,0,107
14,32,24,35,15,2,122,28,30,24,23,15,12,132
34,28,22,18,0,0,102,24,31,34,21,0,0,110
37,29,21,21,0,0,108,24,28,27,28,0,0,107
10,35,26,28,0,0,99,25,25,20,21,0,0,91
28,31,24,27,0,0,110,33,30,29,29,0,0,121
27,28,28,16,0,0,99,29,44,32,22,0,0,127
40,27,22,28,0,0,117,25,32,21,31,0,0,109
35,31,39,28,0,0,133,42,32,33,27,0,0,134
19,31,24,27,0,0,101,35,26,26,24,0,0,111
37,27,31,26,0,0,121,30,38,28,32,0,0,128
31,31,27,22,11,0,122,29,26,27,29,13,0,124
28,27,29,29,0,0,113,22,29,38,25,0,0,114
33,30,34,15,0,0,112,23,28,33,25,0,0,109
20,38,29,31,0,0,118,23,28,28,34,0,0,113
22,26,21,28,0,0,97,40,24,27,28,0,0,119
22,31,22,20,0,0,95,28,27,35,26,0,0,116
33,37,32,27,0,0,129,38,30,34,35,0,0,137
27,28,24,23,0,0,102,35,24,18,29,0,0,106
29,33,31,22,0,0,115,28,29,39,31,0,0,127
27,15,22,23,0,0,87,28,31,36,18,0,0,113
40,21,36,30,0,0,127,28,37,29,26,0,0,120
25,30,24,19,0,0,98,25,31,18,23,0,0,97
20,28,19,25,0,0,92,34,32,29,28,0,0,123
26,33,23,20,0,0,102,38,26,21,29,0,0,114
28,17,22,35,0,0,102,27,27,32,37,0,0,123
23,27,29,28,0,0,107,28,35,32,26,0,0,121
32,29,18,32,0,0,111,30,33,30,26,0,0,119
33,27,19,22,0,0,101,30,17,37,21,0,0,105
16,25,24,18,0,0,83,35,30,32,31,0,0,128
38,31,29,31,0,0,129,34,24,29,32,0,0,119
24,32,37,21,0,0,114,34,32,22,33,0,0,121
26,31,25,24,0,0,106,33,30,22,30,0,0,115
28,36,24,25,0,0,113,31,28,17,33,0,0,109
28,30,25,27,0,0,110,29,28,24,27,0,0,108
22,33,24,26,0,0,105,26,27,33,29,0,0,115
33,21,21,26,0,0,101,21,32,26,28,0,0,107
21,27,27,21,0,0,96,28,29,30,27,0,0,114
29,24,34,28,0,0,115,21,27,29,24,0,0,101
26,31,31,18,0,0,106,35,37,25,18,0,0,115
23,26,36,27,0,0,112,34,36,31,24,0,0,125
26,17,37,25,0,0,105,28,32,23,30,0,0,113
38,14,39,21,0,0,112,26,25,25,22,0,0,98
32,29,29,28,0,0,118,33,29,21,30,0,0,113
38,31,15,36,11,0,131,21,42,34,23,6,0,126
29,37,38,25,0,0,129,19,28,38,25,0,0,110
30,36,32,27,0,0,125,25,29,36,26,0,0,116
29,18,35,25,0,0,107,32,34,32,26,0,0,124
34,28,21,25,0,0,108,29,23,39,19,0,0,110
24,28,30,25,0,0,107,29,27,20,23,0,0,99
25,37,30,24,16,0,132,31,30,25,30,13,0,129
22,40,22,20,0,0,104,36,28,30,28,0,0,122
33,39,32,18,0,0,122,38,31,25,34,0,0,128
35,30,29,23,0,0,117,23,34,31,40,0,0,128
25,23,29,34,0,0,111,44,24,38,26,0,0,132
38,21,26,22,0,0,107,28,28,29,25,0,0,110
30,33,10,29,0,0,102,25,27,35,30,0,0,117
30,29,21,30,9,0,119,32,27,28,23,13,0,123
33,26,20,26,0,0,105,21,20,34,19,0,0,94
22,32,25,23,0,0,102,23,30,31,24,0,0,108
23,28,35,32,0,0,118,37,22,38,32,0,0,129
31,33,23,27,0,0,114,26,26,25,27,0,0,104
29,23,21,27,0,0,100,24,30,27,24,0,0,105
22,22,29,32,0,0,105,23,42,30,23,0,0,118
33,37,36,37,0,0,143,34,34,29,41,0,0,138
32,22,27,31,0,0,112,22,29,27,35,0,0,113
24,33,23,17,0,0,97,31,27,26,27,0,0,111
47,29,33,28,0,0,137,27,29,33,25,0,0,114
29,28,12,31,0,0,100,35,24,23,32,0,0,114
23,28,34,21,0,0,106,31,29,21,17,0,0,98
26,29,33,33,0,0,121,35,37,41,17,0,0,130
20,31,22,29,0,0,102,26,30,22,16,0,0,94
25,29,39,34,0,0,127,26,26,31,40,0,0,123
36,31,32,34,0,0,133,32,13,26,32,0,0,103
33,29,34,19,0,0,115,41,32,31,20,0,0,124
34,21,26,20,0,0,101,23,28,30,23,0,0,104
33,25,39,30,0,0,127,38,39,32,33,0,0,142
19,36,27,23,0,0,105,45,33,43,19,0,0,140
28,23,25,26,0,0,102,23,29,35,22,0,0,109
24,19,24,21,0,0,88,26,26,28,20,0,0,100
26,24,24,27,0,0,101,34,22,25,24,0,0,105
39,29,23,22,0,0,113,42,28,36,23,0,0,129
27,26,33,28,0,0,114,27,33,20,27,0,0,107
31,32,28,31,0,0,122,26,38,20,33,0,0,117
29,27,28,32,0,0,116,32,30,31,22,0,0,115
40,30,38,32,0,0,140,32,24,21,33,0,0,110
24,30,33,26,0,0,113,36,19,37,24,0,0,116
25,28,29,36,0,0,118,30,31,34,17,0,0,112
21,27,18,19,0,0,85,25,44,21,23,0,0,113
38,32,30,25,0,0,125,27,23,26,32,0,0,108
35,25,36,25,0,0,121,38,30,34,32,0,0,134
28,25,24,30,0,0,107,29,28,23,33,0,0,113
22,25,27,35,0,0,109,20,25,26,32,0,0,103
26,22,24,29,0,0,101,27,17,31,34,0,0,109
29,18,31,30,0,0,108,40,34,28,24,0,0,126
35,42,19,15,0,0,111,32,28,28,31,0,0,119
24,23,25,28,0,0,100,44,30,22,24,0,0,120
25,18,38,32,0,0,113,32,32,42,26,0,0,132
26,34,25,27,0,0,112,35,23,36,31,0,0,125
20,28,35,31,0,0,114,33,29,44,31,0,0,137
22,40,20,27,0,0,109,24,42,31,31,0,0,128
36,24,29,28,8,0,125,36,25,38,18,14,0,131
31,28,29,28,0,0,116,36,38,33,10,0,0,117
25,21,35,28,0,0,109,28,32,30,27,0,0,117
27,32,22,29,10,0,120,27,35,25,23,6,0,116
17,32,23,33,0,0,105,41,31,21,21,0,0,114
25,22,17,32,0,0,96,27,27,28,25,0,0,107
33,33,35,32,0,0,133,31,27,39,32,0,0,129
30,24,22,33,0,0,109,29,35,28,25,0,0,117
26,23,32,36,0,0,117,24,28,19,28,0,0,99
27,30,29,36,0,0,122,36,28,32,25,0,0,121
24,35,22,38,0,0,119,35,40,26,38,0,0,139
33,19,30,29,0,0,111,35,28,33,23,0,0,119
20,32,41,28,0,0,121,32,27,15,26,0,0,100
38,22,30,33,0,0,123,24,14,31,27,0,0,96
30,26,28,21,0,0,105,24,21,28,23,0,0,96
32,31,34,38,0,0,135,29,28,44,27,0,0,128
22,26,25,35,0,0,108,36,28,30,27,0,0,121
23,29,28,21,0,0,101,39,29,26,26,0,0,120
40,29,23,24,0,0,116,31,29,30,21,0,0,111
31,29,21,25,0,0,106,27,32,28,34,0,0,121
35,36,35,27,0,0,133,30,11,30,24,0,0,95
35,27,13,28,0,0,103,27,23,19,23,0,0,92
40,29,32,21,0,0,122,26,31,26,29,0,0,112
16,27,20,18,0,0,81,23,23,25,21,0,0,92
27,20,31,23,0,0,101,29,33,20,28,0,0,110
33,35,37,25,0,0,130,27,23,31,38,0,0,119
24,25,25,26,0,0,100,28,26,39,23,0,0,116
28,35,21,35,0,0,119,26,28,36,27,0,0,117
30,26,32,21,0,0,109,21,24,27,30,0,0,102
27,27,30,37,0,0,121,29,30,29,26,0,0,114
27,29,35,25,0,0,116,25,37,18,30,0,0,110
30,25,29,24,9,6,123,27,29,34,18,9,15,132
32,19,26,16,0,0,93,27,31,24,19,0,0,101
15,26,34,36,0,0,111,33,34,29,34,0,0,130
34,25,30,23,0,0,112,21,29,31,23,0,0,104
26,23,34,19,0,0,102,27,30,28,31,0,0,116
20,27,31,38,0,0,116,25,25,23,23,0,0,96
36,28,27,25,0,0,116,29,29,28,29,0,0,115
32,17,29,21,12,0,111,14,26,31,28,17,0,116
28,27,32,29,0,0,116,38,35,23,26,0,0,122
20,21,26,22,0,0,89,31,22,36,24,0,0,113
31,16,28,38,0,0,113,39,31,27,29,0,0,126
22,27,32,30,0,0,111,29,23,28,35,0,0,115
25,27,35,15,0,0,102,27,30,37,29,0,0,123
29,32,33,19,0,0,113,34,34,29,29,0,0,126
17,44,29,25,0,0,115,35,28,27,31,0,0,121
28,15,30,25,0,0,98,27,29,23,25,0,0,104
35,34,22,32,0,0,123,30,36,34,24,0,0,124
31,38,35,21,0,0,125,21,21,23,33,0,0,98
28,26,33,23,0,0,110,20,36,28,31,0,0,115
29,25,23,32,0,0,109,24,27,39,28,0,0,118
30,33,26,32,0,0,121,36,28,35,21,0,0,120
22,33,34,32,0,0,121,20,29,22,31,0,0,102
33,32,24,22,0,0,111,31,38,26,26,0,0,121
25,38,24,22,0,0,109,37,30,27,19,0,0,113
30,34,26,26,0,0,116,36,32,28,24,0,0,120
31,18,30,27,0,0,106,20,29,31,15,0,0,95
20,39,24,37,2,0,122,31,30,32,27,13,0,133
27,26,25,25,0,0,103,34,27,37,16,0,0,114
27,25,30,35,0,0,117,26,29,40,33,0,0,128
28,33,21,36,0,0,118,24,22,33,29,0,0,108
32,20,21,33,0,0,106,33,15,36,21,0,0,105
25,34,27,29,0,0,115,29,28,27,27,0,0,111
40,29,26,41,0,0,136,38,38,24,33,0,0,133
28,32,26,28,0,0,114,29,34,21,23,0,0,107
22,24,26,30,0,0,102,28,31,23,28,0,0,110
30,23,32,30,0,0,115,40,42,31,31,0,0,144
25,38,20,24,0,0,107,33,35,27,28,0,0,123
26,26,38,20,0,0,110,28,33,31,23,0,0,115
27,39,26,26,0,0,118,32,33,29,30,0,0,124
36,22,35,24,7,0,124,29,28,41,19,12,0,129
32,29,30,33,0,0,124,26,23,41,27,0,0,117
22,28,30,19,0,0,99,36,30,29,17,0,0,112
19,20,36,24,0,0,99,18,29,35,29,0,0,111
21,33,33,26,0,0,113,20,41,35,35,0,0,131
27,23,28,32,12,0,122,22,36,27,25,13,0,123
25,23,31,13,0,0,92,19,31,24,23,0,0,97
26,21,20,20,0,0,87,19,23,22,18,0,0,82
29,33,32,18,0,0,112,25,30,28,17,0,0,100
29,22,25,27,0,0,103,35,27,40,26,0,0,128
28,24,38,24,0,0,114,23,43,31,24,0,0,121
27,22,29,33,0,0,111,29,36,27,20,0,0,112
27,32,25,28,0,0,112,33,37,36,27,0,0,133
25,22,25,21,0,0,93,29,27,32,25,0,0,113
32,23,28,20,0,0,103,39,41,21,22,0,0,123
27,25,25,34,0,0,111,38,26,31,33,0,0,128
20,15,32,30,0,0,97,27,27,30,27,0,0,111
30,15,26,29,0,0,100,29,23,39,30,0,0,121
37,28,23,22,12,0,122,24,26,32,28,8,0,118
35,38,34,20,14,0,141,33,36,28,30,7,0,134
26,28,33,32,0,0,119,27,47,19,32,0,0,125
22,40,32,30,0,0,124,50,26,29,30,0,0,135
29,35,28,25,11,0,128,28,27,33,29,3,0,120
23,36,29,36,0,0,124,31,31,32,29,0,0,123
31,33,22,24,0,0,110,31,21,32,24,0,0,108
39,34,24,31,0,0,128,28,29,32,23,0,0,112
26,34,23,22,0,0,105,19,22,27,22,0,0,90
31,36,28,33,0,0,128,38,34,30,39,0,0,141
21,22,22,23,0,0,88,19,19,29,32,0,0,99
29,37,20,25,0,0,111,29,23,33,23,0,0,108
18,23,30,30,0,0,101,33,37,47,25,0,0,142
25,37,33,28,6,0,129,27,31,33,32,9,0,132
29,35,25,22,0,0,111,18,19,33,25,0,0,95
38,37,23,27,0,0,125,24,35,33,14,0,0,106
28,27,38,29,0,0,122,29,34,23,27,0,0,113
32,30,26,29,0,0,117,28,26,27,28,0,0,109
31,30,33,18,0,0,112,29,25,29,35,0,0,118
38,19,24,25,0,0,106,33,22,33,30,0,0,118
19,33,36,31,0,0,119,29,33,22,32,0,0,116
29,29,29,27,0,0,114,32,21,22,16,0,0,91
30,33,25,24,0,0,112,28,22,41,19,0,0,110
32,31,22,25,0,0,110,31,41,38,20,0,0,130
32,33,23,20,0,0,108,33,31,29,33,0,0,126
28,29,18,18,0,0,93,20,30,22,30,0,0,102
25,27,28,31,0,0,111,28,27,29,17,0,0,101
29,20,26,21,3,0,99,27,20,20,29,4,0,100
33,24,28,22,0,0,107,27,24,14,30,0,0,95
22,25,36,14,0,0,97,27,29,36,31,0,0,123
21,22,33,33,0,0,109,25,39,27,24,0,0,115
34,29,26,25,0,0,114,27,19,38,34,0,0,118
26,24,18,27,0,0,95,23,18,30,21,0,0,92
29,25,30,25,0,0,109,28,25,32,21,0,0,106
21,33,44,26,0,0,124,35,36,25,25,0,0,121
36,32,34,24,0,0,126,26,28,26,30,0,0,110
34,31,32,29,0,0,126,32,39,42,37,0,0,150
25,27,28,35,0,0,115,20,35,39,25,0,0,119
29,23,36,29,0,0,117,30,36,21,32,0,0,119
21,23,27,28,0,0,99,29,33,28,32,0,0,122
23,23,32,21,2,0,101,22,35,21,21,5,0,104
27,38,29,31,0,0,125,34,34,36,22,0,0,126
35,25,32,32,0,0,124,28,34,14,29,0,0,105
30,14,30,32,0,0,106,21,36,37,22,0,0,116
30,36,34,28,0,0,128,27,34,29,29,0,0,119
28,30,36,27,0,0,121,28,33,33,29,0,0,123
24,20,33,27,0,0,104,38,30,31,31,0,0,130
39,27,25,34,0,0,125,30,33,29,27,0,0,119
31,30,34,31,0,0,126,24,36,25,26,0,0,111
31,21,36,25,0,0,113,21,36,20,26,0,0,103
25,31,25,13,0,0,94,33,36,31,32,0,0,132
27,26,27,33,0,0,113,30,18,30,32,0,0,110
14,26,31,20,0,0,91,35,20,29,21,0,0,105
20,22,35,29,0,0,106,35,25,33,21,0,0,114
29,22,27,15,0,0,93,37,26,29,21,0,0,113
30,31,20,29,0,0,110,25,26,26,31,0,0,108
42,29,29,17,0,0,117,22,21,42,27,0,0,112
17,34,28,34,0,0,113,46,45,18,34,0,0,143
28,35,24,26,0,0,113,27,26,27,26,0,0,106
25,29,31,31,0,0,116,31,33,23,23,0,0,110
29,22,24,29,0,0,104,31,21,22,25,0,0,99
32,22,24,20,0,0,98,22,27,29,23,0,0,101
26,32,28,34,0,0,120,25,41,40,28,0,0,134
19,21,34,31,0,0,105,37,34,26,29,0,0,126
17,29,29,42,0,0,117,37,28,29,32,0,0,126
27,39,24,22,0,0,112,30,30,33,27,0,0,120
28,33,28,24,0,0,113,34,27,33,39,0,0,133
33,30,22,29,0,0,114,24,27,34,34,0,0,119
34,29,18,24,0,0,105,32,28,35,35,0,0,130
29,27,30,23,0,0,109,22,32,34,33,0,0,121
29,18,28,25,0,0,100,36,24,25,33,0,0,118
39,30,29,20,0,0,118,31,22,25,29,0,0,107
29,29,31,29,0,0,118,22,38,32,25,0,0,117
30,31,20,31,0,0,112,24,26,34,22,0,0,106
31,25,28,27,0,0,111,28,30,24,26,0,0,108
33,31,16,32,16,0,128,23,23,31,35,13,0,125
27,37,16,27,0,0,107,32,26,35,27,0,0,120
39,20,38,28,0,0,125,20,18,31,31,0,0,100
28,40,34,23,0,0,125,27,23,33,28,0,0,111
27,40,30,37,0,0,134,31,36,20,43,0,0,130
25,35,35,24,0,0,119,37,26,33,16,0,0,112
28,26,21,40,0,0,115,21,22,51,30,0,0,124
28,33,25,32,0,0,118,36,26,38,39,0,0,139
29,25,30,25,0,0,109,33,26,40,24,0,0,123
24,33,27,29,12,0,125,28,23,30,32,15,0,128
34,31,26,34,0,0,125,22,27,30,38,0,0,117
31,35,30,32,14,0,142,36,25,39,28,3,0,131
31,25,30,24,0,0,110,33,26,34,20,0,0,113
36,28,35,34,0,0,133,26,39,24,29,0,0,118
18,20,24,31,0,0,93,24,33,33,23,0,0,113
26,30,26,40,0,0,122,31,32,33,30,0,0,126
34,33,28,18,0,0,113,30,31,40,23,0,0,124
33,32,27,37,0,0,129,27,28,28,27,0,0,110
30,26,29,26,0,0,111,32,35,27,22,0,0,116
21,28,32,21,0,0,102,22,34,36,34,0,0,126
27,27,32,28,0,0,114,30,34,32,33,0,0,129
27,33,37,27,0,0,124,29,27,26,31,0,0,113
23,42,32,28,0,0,125,22,27,31,28,0,0,108
33,27,33,21,0,0,114,38,32,25,35,0,0,130
30,33,29,23,6,0,121,28,27,27,33,11,0,126
26,26,26,27,0,0,105,37,28,24,21,0,0,110
20,27,32,34,0,0,113,32,24,27,23,0,0,106
23,24,30,24,0,0,101,27,39,26,29,0,0,121
21,34,29,18,0,0,102,36,28,29,34,0,0,127
31,25,27,25,0,0,108,30,33,17,27,0,0,107
25,27,26,20,0,0,98,33,28,34,17,0,0,112
32,23,27,24,7,0,113,28,29,22,27,13,0,119
28,27,33,30,0,0,118,24,25,37,33,0,0,119
37,22,35,13,0,0,107,27,27,34,24,0,0,112
40,35,30,21,0,0,126,24,38,32,33,0,0,127
30,30,24,29,0,0,113,36,21,28,36,0,0,121
34,34,28,30,0,0,126,29,35,35,36,0,0,135
26,23,36,25,0,0,110,27,33,24,32,0,0,116
30,27,36,26,0,0,119,20,23,32,31,0,0,106
29,24,26,36,0,0,115,38,26,28,30,0,0,122
30,21,28,35,0,0,114,36,29,34,30,0,0,129
27,29,42,21,0,0,119,20,27,26,27,0,0,100
23,39,36,32,0,0,130,33,34,28,26,0,0,121
24,27,28,25,0,0,104,33,20,33,27,0,0,113
25,33,34,26,0,0,118,33,27,35,37,0,0,132
34,27,22,31,0,0,114,33,17,39,34,0,0,123
27,33,31,25,0,0,116,31,36,32,28,0,0,127
19,38,33,29,0,0,119,23,37,25,39,0,0,124
25,31,40,16,0,0,112,41,19,28,30,0,0,118
27,30,30,38,0,0,125,30,30,31,35,0,0,126
22,33,38,37,0,0,130,32,30,31,38,0,0,131
28,32,24,19,0,0,103,30,25,22,25,0,0,102
32,29,36,26,0,0,123,22,27,30,27,0,0,106
27,26,29,26,0,0,108,35,14,21,18,0,0,88
32,36,35,23,0,0,126,30,34,29,32,0,0,125
25,25,29,22,0,0,101,31,22,30,33,0,0,116
28,22,38,28,0,0,116,39,25,24,16,0,0,104
38,31,20,26,0,0,115,20,23,29,24,0,0,96
31,38,27,30,0,0,126,30,33,35,25,0,0,123
28,26,31,26,0,0,111,37,25,36,25,0,0,123
26,32,29,21,0,0,108,27,32,32,27,0,0,118
34,34,20,30,0,0,118,17,33,20,25,0,0,95
11,20,27,25,0,0,83,23,31,25,23,0,0,102
22,38,34,27,0,0,121,21,24,31,39,0,0,115
34,31,31,34,4,0,134,27,20,44,39,15,0,145
33,24,33,24,0,0,114,29,37,25,31,0,0,122
25,27,29,30,0,0,111,33,24,27,36,0,0,120
25,22,32,24,0,0,103,37,37,34,31,0,0,139
18,26,39,28,0,0,111,26,29,32,19,0,0,106
23,30,32,26,0,0,111,23,36,31,34,0,0,124
26,27,42,26,11,9,141,38,32,25,26,11,11,143
27,25,30,24,0,0,106,22,39,41,33,0,0,135
34,33,14,29,0,0,110,28,21,34,17,0,0,100
28,21,36,28,0,0,113,32,29,29,33,0,0,123
33,21,37,26,0,0,117,34,40,48,28,0,0,150
35,25,28,29,0,0,117,23,28,38,26,0,0,115
40,36,26,29,0,0,131,26,21,26,34,0,0,107
14,29,21,24,0,0,88,15,18,26,31,0,0,90
28,25,35,27,0,0,115,31,39,25,31,0,0,126
28,33,23,36,6,0,126,27,39,31,23,9,0,129
29,26,34,25,0,0,114,39,23,32,23,0,0,117
13,26,24,34,7,0,104,12,26,21,38,4,0,101
33,26,26,27,0,0,112,40,29,19,33,0,0,121
24,29,32,21,0,0,106,29,31,29,24,0,0,113
22,30,21,35,0,0,108,45,30,23,21,0,0,119
34,26,31,31,0,0,122,26,30,32,31,0,0,119
23,25,30,31,0,0,109,32,20,27,33,0,0,112
30,31,30,29,0,0,120,30,28,30,29,0,0,117
22,43,27,31,0,0,123,20,23,35,37,0,0,115
29,35,25,35,0,0,124,20,26,19,30,0,0,95
31,33,31,36,0,0,131,23,33,30,28,0,0,114
15,17,27,32,0,0,91,32,34,36,20,0,0,122
29,26,27,17,0,0,99,26,28,27,27,0,0,108
25,34,40,27,0,0,126,30,25,29,28,0,0,112
27,26,35,20,0,0,108,28,36,21,17,0,0,102
30,27,24,31,0,0,112,26,21,31,30,0,0,108
51,33,28,26,0,0,138,28,32,27,22,0,0,109
17,25,38,30,0,0,110,35,33,35,24,0,0,127
28,20,28,33,0,0,109,31,20,35,35,0,0,121
28,30,24,26,0,0,108,26,36,32,27,0,0,121
33,21,25,36,0,0,115,37,31,32,28,0,0,128
30,21,27,26,0,0,104,23,23,27,23,0,0,96
28,21,33,32,0,0,114,37,33,28,32,0,0,130
33,35,25,28,0,0,121,30,27,32,27,0,0,116
24,25,40,29,0,0,118,28,25,31,42,0,0,126
15,31,35,36,0,0,117,34,29,34,30,0,0,127
28,34,30,23,0,0,115,29,30,23,19,0,0,101
37,36,36,27,0,0,136,38,35,36,25,0,0,134
35,36,29,23,0,0,123,27,27,28,29,0,0,111
27,26,21,31,0,0,105,34,24,31,28,0,0,117
27,18,34,32,0,0,111,15,32,26,43,0,0,116
24,28,38,28,0,0,118,23,43,32,25,0,0,123
31,35,13,23,0,0,102,30,34,18,19,0,0,101
24,34,19,27,0,0,104,33,29,19,15,0,0,96
34,21,28,26,0,0,109,33,36,27,24,0,0,120
35,22,23,32,0,0,112,26,28,25,19,0,0,98
25,41,19,27,0,0,112,26,26,35,21,0,0,108
35,33,32,32,0,0,132,37,19,32,24,0,0,112
25,25,23,26,0,0,99,28,31,25,23,0,0,107
22,24,27,38,0,0,111,22,29,27,29,0,0,107
25,36,31,21,0,0,113,35,37,25,24,0,0,121
23,25,31,30,0,0,109,29,33,32,28,0,0,122
31,21,32,27,0,0,111,41,31,35,29,0,0,136
20,23,32,41,0,0,116,27,38,42,40,0,0,147
26,30,32,23,0,0,111,31,32,26,23,0,0,112
34,32,28,26,0,0,120,35,37,24,36,0,0,132
24,31,29,30,0,0,114,31,24,33,28,0,0,116
31,28,39,27,0,0,125,26,19,34,34,0,0,113
33,17,32,27,0,0,109,20,30,23,33,0,0,106
25,22,31,23,0,0,101,31,38,19,25,0,0,113
34,30,23,31,0,0,118,31,34,36,34,0,0,135
29,30,21,17,0,0,97,25,21,41,13,0,0,100
39,28,22,25,0,0,114,19,27,36,23,0,0,105
32,26,27,29,0,0,114,35,29,33,28,0,0,125
21,20,40,32,0,0,113,37,25,33,24,0,0,119
37,25,35,32,0,0,129,32,44,36,23,0,0,135
28,26,21,22,0,0,97,34,36,30,26,0,0,126
27,35,33,20,0,0,115,31,36,27,41,0,0,135
35,32,34,32,0,0,133,35,22,28,29,0,0,114
29,31,24,25,0,0,109,31,26,25,16,0,0,98
23,22,28,29,0,0,102,14,31,33,30,0,0,108
29,26,33,26,0,0,114,38,31,28,27,0,0,124
36,23,23,19,7,11,119,22,26,28,25,7,7,115
27,24,36,32,0,0,119,32,26,33,22,0,0,113
32,27,33,24,0,0,116,28,22,33,27,0,0,110
36,19,29,29,0,0,113,27,31,31,22,0,0,111
19,31,30,32,0,0,112,21,32,23,32,0,0,108
33,41,40,30,0,0,144,28,32,29,24,0,0,113
33,39,19,33,0,0,124,31,27,32,20,0,0,110
25,24,26,41,0,0,116,35,29,28,29,0,0,121
27,29,27,25,0,0,108,36,25,27,24,0,0,112
32,25,29,29,0,0,115,34,24,23,22,0,0,103
32,34,26,22,0,0,114,36,33,43,27,0,0,139
20,25,26,24,0,0,95,28,25,24,34,0,0,111
31,31,33,27,0,0,122,34,32,19,21,0,0,106
36,32,29,33,0,0,130,28,24,27,33,0,0,112
34,35,27,18,0,0,114,25,32,22,24,0,0,103
25,29,26,22,0,0,102,27,22,28,33,0,0,110
41,25,22,30,0,0,118,24,32,29,32,0,0,117
30,26,34,29,0,0,119,31,40,35,30,0,0,136
39,23,28,27,0,0,117,22,33,25,24,0,0,104
30,33,27,10,0,0,100,31,31,29,30,0,0,121
20,42,24,32,0,0,118,35,24,33,40,0,0,132
28,20,27,37,0,0,112,24,26,30,22,0,0,102
33,30,39,30,0,0,132,32,32,26,29,0,0,119
25,29,34,28,0,0,116,31,38,25,25,0,0,119
31,23,41,28,0,0,123,33,28,37,42,0,0,140
33,24,29,27,0,0,113,32,26,25,29,0,0,112
35,31,26,38,0,0,130,22,33,31,32,0,0,118
38,38,22,21,0,0,119,32,33,28,39,0,0,132
25,25,31,22,0,0,103,24,23,31,35,0,0,113
29,27,25,29,13,0,123,25,34,28,23,11,0,121
35,34,24,34,0,0,127,33,31,29,25,0,0,118
26,24,30,33,0,0,113,38,32,21,30,0,0,121
27,25,35,39,0,0,126,27,31,37,30,0,0,125
36,29,23,18,0,0,106,29,39,39,29,0,0,136
35,26,37,34,0,0,132,37,36,29,38,0,0,140
34,40,23,25,0,0,122,44,23,38,25,0,0,130
15,36,17,30,0,0,98,27,24,25,30,0,0,106
31,36,22,24,0,0,113,34,39,28,21,0,0,122
34,29,27,30,0,0,120,27,25,37,21,0,0,110
40,25,33,32,0,0,130,37,25,35,25,0,0,122
35,21,32,28,0,0,116,22,26,30,27,0,0,105
36,17,30,39,0,0,122,31,29,24,33,0,0,117
30,31,30,23,0,0,114,31,37,21,26,0,0,115
36,34,28,26,0,0,124,23,28,25,22,0,0,98
20,24,29,33,0,0,106,36,22,42,26,0,0,126
26,30,25,22,0,0,103,36,32,27,31,0,0,126
27,33,35,23,0,0,118,30,25,33,34,0,0,122
28,33,29,26,0,0,116,39,21,22,29,0,0,111
31,34,28,33,0,0,126,24,32,23,29,0,0,108
26,29,34,17,12,0,118,25,29,28,24,15,0,121
37,39,33,17,0,0,126,31,35,35,27,0,0,128
29,22,23,38,0,0,112,35,30,29,23,0,0,117
26,31,22,26,0,0,105,14,20,31,30,0,0,95
30,30,31,19,0,0,110,23,33,32,35,0,0,123
38,33,30,23,0,0,124,35,33,34,37,0,0,139
33,31,34,22,0,0,120,28,31,27,28,0,0,114
19,32,16,23,0,0,90,31,29,32,23,0,0,115
41,24,33,33,0,0,131,36,36,23,31,0,0,126
28,25,29,29,0,0,111,37,24,38,35,0,0,134
28,23,32,34,0,0,117,22,33,28,23,0,0,106
23,30,36,32,0,0,121,26,23,32,41,0,0,122
32,34,22,25,0,0,113,33,26,32,27,0,0,118
26,24,31,25,0,0,106,27,30,28,19,0,0,104
26,31,34,27,0,0,118,37,33,30,38,0,0,138
25,24,36,37,0,0,122,31,34,28,25,0,0,118
26,21,34,21,0,0,102,23,27,36,28,0,0,114
26,26,32,20,0,0,104,26,24,37,26,0,0,113
27,30,26,24,0,0,107,29,30,28,25,0,0,112
27,37,38,27,0,0,129,35,39,22,31,0,0,127
22,27,30,33,0,0,112,20,34,25,19,0,0,98
32,15,25,24,0,0,96,23,18,28,31,0,0,100
22,31,33,30,0,0,116,37,25,24,39,0,0,125
27,25,29,20,0,0,101,18,29,27,25,0,0,99
18,19,35,38,0,0,110,32,30,25,25,0,0,112
28,32,26,34,0,0,120,33,39,18,26,0,0,116
33,13,40,35,0,0,121,26,45,20,21,0,0,112
49,34,32,35,0,0,150,24,31,37,38,0,0,130
23,31,25,19,0,0,98,30,25,33,25,0,0,113
21,27,30,22,0,0,100,17,40,21,33,0,0,111
26,30,25,33,0,0,114,31,25,34,29,0,0,119
24,21,34,23,0,0,102,21,37,31,31,0,0,120
38,36,27,26,0,0,127,40,34,45,28,0,0,147
33,28,29,10,0,0,100,47,19,34,33,0,0,133
33,29,25,23,0,0,110,21,25,34,36,0,0,116
30,28,24,13,0,0,95,32,18,25,23,0,0,98
27,24,24,28,0,0,103,34,19,27,25,0,0,105
28,35,20,16,0,0,99,24,23,27,24,0,0,98
32,33,34,28,0,0,127,28,32,37,29,0,0,126
15,32,30,20,0,0,97,36,22,40,30,0,0,128
37,40,21,35,0,0,133,30,24,28,33,0,0,115
29,39,23,29,0,0,120,46,27,29,24,0,0,126
41,24,33,35,0,0,133,41,34,32,30,0,0,137
25,18,28,37,0,0,108,30,28,23,22,0,0,103
27,26,20,26,0,0,99,26,32,23,26,0,0,107
26,20,39,26,0,0,111,34,18,21,29,0,0,102
39,38,32,28,0,0,137,43,34,27,28,0,0,132
22,32,42,24,0,0,120,24,29,37,32,0,0,122
31,33,27,33,0,0,124,19,47,36,32,0,0,134
24,34,26,29,0,0,113,23,27,17,28,0,0,95
30,24,28,22,0,0,104,25,28,28,32,0,0,113
26,32,33,19,10,0,120,34,26,25,25,7,0,117
30,28,43,29,0,0,130,27,32,31,32,0,0,122
36,19,24,17,0,0,96,32,15,30,34,0,0,111
37,37,23,16,0,0,113,25,23,26,21,0,0,95
32,22,22,23,0,0,99,32,16,21,26,0,0,95
25,32,24,19,0,0,100,41,37,26,34,0,0,138
45,40,29,27,0,0,141,30,26,43,32,0,0,131
31,22,24,23,0,0,100,38,24,25,24,0,0,111
31,28,20,26,0,0,105,26,24,23,37,0,0,110
25,29,24,22,0,0,100,27,20,31,34,0,0,112
36,26,32,23,0,0,117,34,29,35,31,0,0,129
38,35,26,20,0,0,119,29,29,38,30,0,0,126
22,27,32,34,0,0,115,28,34,26,34,0,0,122
27,32,24,34,0,0,117,37,20,29,28,0,0,114
25,35,35,33,0,0,128,19,28,34,28,0,0,109
22,36,26,36,0,0,120,28,25,28,32,0,0,113
21,38,22,29,0,0,110,29,28,33,27,0,0,117
32,27,29,25,0,0,113,30,20,24,29,0,0,103
33,22,32,23,18,0,128,26,22,28,34,8,0,118
27,27,27,24,16,0,121,28,20,33,24,20,0,125
23,25,28,24,0,0,100,34,32,18,24,0,0,108
37,26,25,35,0,0,123,14,30,39,22,0,0,105
28,34,24,31,0,0,117,26,32,33,31,0,0,122
32,30,17,21,0,0,100,23,27,30,32,0,0,112
15,19,23,42,0,0,99,31,33,25,33,0,0,122
19,25,44,22,0,0,110,37,25,44,29,0,0,135
17,35,42,25,0,0,119,30,32,28,19,0,0,109
16,30,36,22,0,0,104,29,29,27,36,0,0,121
24,27,27,25,15,0,118,17,36,28,22,8,0,111
38,25,31,34,0,0,128,20,28,37,35,0,0,120
30,33,35,29,0,0,127,36,19,32,19,0,0,106
27,30,27,21,0,0,105,30,23,30,28,0,0,111
28,25,31,22,0,0,106,31,31,20,32,0,0,114
23,37,32,33,0,0,125,31,33,35,30,0,0,129
24,31,24,21,0,0,100,26,26,27,18,0,0,97
29,23,34,28,15,0,129,24,29,30,31,9,0,123
20,34,31,23,0,0,108,32,26,26,19,0,0,103
27,37,26,25,0,0,115,34,30,33,27,0,0,124
35,25,24,29,0,0,113,31,26,36,29,0,0,122
26,26,32,38,0,0,122,32,25,33,22,0,0,112
23,30,25,16,0,0,94,37,19,26,23,0,0,105
16,29,27,24,0,0,96,46,33,31,29,0,0,139
25,33,28,20,0,0,106,34,33,17,28,0,0,112
34,37,22,17,4,0,114,32,30,20,28,9,0,119
30,31,28,30,0,0,119,31,23,30,25,0,0,109
25,35,32,36,0,0,128,31,34,31,35,0,0,131
26,40,36,30,0,0,132,23,24,20,33,0,0,100
30,24,30,28,0,0,112,35,32,29,15,0,0,111
26,28,33,26,0,0,113,30,37,32,29,0,0,128
22,26,24,32,0,0,104,28,23,26,29,0,0,106
29,20,21,28,0,0,98,31,22,32,29,0,0,114
22,21,33,30,0,0,106,40,30,25,16,0,0,111
35,34,22,26,0,0,117,34,36,35,29,0,0,134
24,32,31,18,0,0,105,15,34,29,28,0,0,106
30,38,26,18,0,0,112,29,40,23,26,0,0,118
27,21,32,24,0,0,104,28,32,27,20,0,0,107
19,32,39,34,0,0,124,36,33,25,22,0,0,116
24,33,17,32,0,0,106,20,24,29,21,0,0,94
20,35,30,32,0,0,117,21,27,24,39,0,0,111
27,37,26,37,0,0,127,34,23,18,45,0,0,120
26,47,33,31,0,0,137,26,35,26,38,0,0,125
32,30,29,24,0,0,115,22,28,28,30,0,0,108
44,29,26,24,0,0,123,25,30,37,33,0,0,125
32,40,34,20,0,0,126,30,31,42,28,0,0,131
30,28,30,28,0,0,116,27,22,27,24,0,0,100
36,27,33,19,19,0,134,28,28,25,34,13,0,128
27,43,17,34,0,0,121,34,25,33,37,0,0,129
26,36,30,23,0,0,115,34,28,32,29,0,0,123
19,34,28,40,0,0,121,38,41,44,30,0,0,153
23,35,28,27,0,0,113,40,33,29,17,0,0,119
30,22,34,22,0,0,108,35,35,27,31,0,0,128
28,34,28,29,0,0,119,37,21,27,28,0,0,113
27,35,36,24,0,0,122,25,21,38,19,0,0,103
28,31,19,28,0,0,106,31,31,24,17,0,0,103
35,18,26,18,0,0,97,24,27,25,32,0,0,108
21,22,28,27,0,0,98,32,31,31,34,0,0,128
26,26,24,28,0,0,104,34,36,34,32,0,0,136
26,34,30,21,0,0,111,25,28,19,27,0,0,99
37,29,30,18,0,0,114,25,21,26,19,0,0,91
29,26,36,33,0,0,124,27,26,35,28,0,0,116
28,31,26,19,0,0,104,39,23,28,38,0,0,128
31,34,34,41,0,0,140,24,24,40,32,0,0,120
25,35,29,35,0,0,124,37,25,23,26,0,0,111
37,16,26,35,0,0,114,31,29,44,37,0,0,141
30,28,37,32,0,0,127,22,26,23,37,0,0,108
22,18,26,36,0,0,102,26,22,21,29,0,0,98
24,33,30,29,0,0,116,25,26,30,31,0,0,112
35,24,22,26,0,0,107,33,29,29,25,0,0,116
14,25,36,14,0,0,89,26,23,23,32,0,0,104
19,29,27,37,0,0,112,49,30,31,36,0,0,146
36,40,28,29,0,0,133,34,32,33,31,0,0,130
14,26,28,17,0,0,85,32,19,25,37,0,0,113
31,30,15,28,0,0,104,32,29,27,30,0,0,118
27,28,24,20,0,0,99,30,29,27,20,0,0,106
30,33,20,28,0,0,111,39,21,29,27,0,0,116
24,30,21,23,0,0,98,34,23,31,24,0,0,112
30,28,41,31,0,0,130,37,25,35,31,0,0,128
33,44,40,26,0,0,143,31,36,21,30,0,0,118
41,19,21,29,0,0,110,25,27,26,26,0,0,104
27,40,28,27,0,0,122,34,29,32,30,0,0,125
26,29,29,20,0,0,104,29,36,24,26,0,0,115
22,25,28,32,0,0,107,36,20,37,23,0,0,116
26,24,34,21,0,0,105,19,34,26,37,0,0,116
26,24,38,27,0,0,115,31,27,23,25,0,0,106
28,26,29,30,12,6,131,19,34,38,22,12,13,138
30,30,35,22,0,0,117,24,23,30,27,0,0,104
36,29,28,15,0,0,108,28,31,33,27,0,0,119
24,29,28,35,0,0,116,32,39,26,30,0,0,127
28,30,25,39,0,0,122,34,27,35,20,0,0,116
32,26,28,21,0,0,107,31,38,34,25,0,0,128
29,27,17,22,0,0,95,28,30,17,22,0,0,97
38,35,28,17,0,0,118,28,28,26,25,0,0,107
33,39,31,35,0,0,138,35,33,37,24,0,0,129
45,29,27,21,0,0,122,25,31,31,27,0,0,114
22,32,27,38,0,0,119,27,24,25,30,0,0,106
26,26,24,25,0,0,101,28,32,22,16,0,0,98
27,30,37,25,0,0,119,34,26,23,22,0,0,105
19,27,26,25,10,0,107,29,25,25,18,6,0,103
29,28,31,25,0,0,113,37,43,24,23,0,0,127
31,29,17,29,0,0,106,32,29,32,32,0,0,125
28,28,28,36,0,0,120,33,29,25,39,0,0,126
29,20,25,15,0,0,89,26,14,29,28,0,0,97
21,30,34,24,0,0,109,22,31,26,24,0,0,103
32,32,24,26,14,0,128,34,28,24,28,19,0,133
28,20,33,28,0,0,109,26,35,21,37,0,0,119
29,23,25,41,0,0,118,31,22,31,35,0,0,119
27,41,28,42,0,0,138,36,38,35,35,0,0,144
19,30,32,28,0,0,109,34,31,26,26,0,0,117
27,26,36,34,0,0,123,33,18,37,29,0,0,117
29,19,30,26,0,0,104,32,23,35,33,0,0,123
27,38,24,23,0,0,112,36,26,21,25,0,0,108
26,35,22,23,0,0,106,32,26,35,31,0,0,124
25,24,27,24,0,0,100,21,23,24,23,0,0,91
33,27,16,27,0,0,103,25,26,22,27,0,0,100
33,32,35,24,0,0,124,23,31,28,39,0,0,121
39,27,27,33,0,0,126,29,42,35,29,0,0,135
19,27,33,36,0,0,115,34,31,36,26,0,0,127
35,28,32,21,9,0,125,27,37,26,26,15,0,131
27,43,19,24,0,0,113,35,30,29,29,0,0,123
29,29,28,23,0,0,109,27,35,28,30,0,0,120
23,42,28,31,0,0,124,31,30,44,29,0,0,134
31,28,38,29,0,0,126,27,25,22,27,0,0,101
32,25,29,24,0,0,110,32,28,33,27,0,0,120
39,19,28,27,0,0,113,15,27,40,35,0,0,117
37,29,25,31,0,0,122,21,23,32,25,0,0,101
26,25,38,20,0,0,109,31,35,31,30,0,0,127
25,31,24,25,0,0,105,26,26,31,33,0,0,116
24,14,32,42,0,0,112,38,25,24,31,0,0,118
24,23,33,31,0,0,111,38,25,25,29,0,0,117
21,33,24,18,0,0,96,38,38,40,17,0,0,133
25,19,30,35,0,0,109,26,35,31,26,0,0,118
25,26,24,27,0,0,102,38,17,34,31,0,0,120
34,27,24,27,0,0,112,24,25,24,27,0,0,100
21,30,25,38,0,0,114,36,23,28,19,0,0,106
28,26,37,25,0,0,116,23,29,32,23,0,0,107
31,25,33,26,0,0,115,26,31,34,18,0,0,109
34,34,32,25,17,0,142,31,27,39,28,13,0,138
26,20,33,27,0,0,106,28,19,33,28,0,0,108
37,22,22,24,0,0,105,22,25,28,35,0,0,110
19,26,32,33,0,0,110,23,31,38,23,0,0,115
26,37,27,26,0,0,116,34,40,25,43,0,0,142
26,29,31,20,13,0,119,28,18,32,28,14,0,120
23,33,24,31,0,0,111,31,28,36,29,0,0,124
37,20,34,25,0,0,116,29,37,34,33,0,0,133
27,33,29,26,0,0,115,38,26,24,21,0,0,109
23,34,26,36,0,0,119,32,49,27,28,0,0,136
32,24,18,25,0,0,99,42,31,22,33,0,0,128
18,11,22,36,0,0,87,33,30,34,34,0,0,131
37,35,24,25,0,0,121,32,32,25,24,0,0,113
26,23,28,24,0,0,101,26,40,20,30,0,0,116
30,30,27,28,0,0,115,29,36,29,30,0,0,124
40,36,34,43,11,12,176,40,40,37,36,11,11,175
22,22,27,24,0,0,95,22,22,26,21,0,0,91
16,35,21,31,0,0,103,29,25,28,26,0,0,108
27,24,31,39,0,0,121,25,27,22,34,0,0,108
26,26,30,24,0,0,106,42,31,29,26,0,0,128
20,22,20,32,0,0,94,28,38,28,18,0,0,112
28,22,30,30,0,0,110,30,26,22,29,0,0,107
33,32,14,23,0,0,102,24,31,30,33,0,0,118
26,20,28,27,0,0,101,33,20,22,29,0,0,104
29,28,37,33,0,0,127,37,27,33,32,0,0,129
27,18,22,15,0,0,82,25,22,27,28,0,0,102
16,31,31,33,0,0,111,28,33,20,27,0,0,108
28,24,24,17,0,0,93,34,30,28,26,0,0,118
36,22,36,30,0,0,124,26,24,40,25,0,0,115
34,23,30,17,0,0,104,25,34,19,31,0,0,109
31,27,30,26,0,0,114,32,41,29,29,0,0,131
22,36,30,32,4,0,124,35,31,31,23,14,0,134
21,25,30,30,0,0,106,41,24,27,25,0,0,117
28,30,26,17,0,0,101,22,28,30,19,0,0,99
15,31,29,19,0,0,94,27,33,28,21,0,0,109
36,14,29,22,0,0,101,25,24,25,19,0,0,93
27,25,33,34,0,0,119,27,29,34,26,0,0,116
22,30,39,27,0,0,118,34,28,23,19,0,0,104
22,27,35,25,0,0,109,26,20,47,28,0,0,121
23,23,26,26,0,0,98,24,20,26,34,0,0,104
41,33,32,27,0,0,133,30,24,30,28,0,0,112
44,27,22,30,0,0,123,38,28,21,30,0,0,117
31,38,37,18,0,0,124,33,26,39,24,0,0,122
32,18,21,31,0,0,102,30,18,25,21,0,0,94
41,24,17,23,0,0,105,27,21,39,36,0,0,123
26,32,28,22,0,0,108,33,23,19,26,0,0,101
27,30,22,26,0,0,105,22,19,32,18,0,0,91
38,31,32,16,0,0,117,36,18,32,29,0,0,115
28,24,26,35,0,0,113,26,29,41,21,0,0,117
34,37,25,23,0,0,119,38,15,24,19,0,0,96
29,28,30,31,0,0,118,47,34,29,32,0,0,142
25,22,38,28,0,0,113,19,25,24,31,0,0,99
29,37,30,21,0,0,117,31,45,32,31,0,0,139
31,26,33,33,0,0,123,30,30,24,33,0,0,117
29,24,37,31,0,0,121,31,25,35,19,0,0,110
20,30,28,30,0,0,108,24,35,30,30,0,0,119
37,30,24,35,0,0,126,38,33,39,23,0,0,133
29,25,16,29,0,0,99,21,31,31,27,0,0,110
27,29,16,19,0,0,91,26,19,42,28,0,0,115
31,33,27,26,0,0,117,26,22,25,33,0,0,106
19,30,27,35,0,0,111,31,28,38,32,0,0,129
15,40,34,26,0,0,115,37,27,20,21,0,0,105
40,20,34,31,0,0,125,29,35,21,19,0,0,104
37,34,25,26,0,0,122,31,25,32,32,0,0,120
29,23,32,19,0,0,103,34,33,30,33,0,0,130
27,31,22,17,0,0,97,28,22,30,33,0,0,113
35,22,21,21,0,0,99,21,33,28,26,0,0,108
32,31,33,31,0,0,127,35,33,33,27,0,0,128
33,23,27,27,0,0,110,34,21,21,26,0,0,102
26,27,33,19,11,0,116,30,23,26,26,4,0,109
21,24,22,23,0,0,90,24,30,42,18,0,0,114
26,23,26,34,0,0,109,29,37,21,30,0,0,117
29,41,25,27,0,0,122,32,36,22,20,0,0,110
29,24,32,48,0,0,133,29,30,40,31,0,0,130
36,38,31,33,0,0,138,30,34,38,32,0,0,134
31,28,37,34,0,0,130,25,37,33,31,0,0,126
30,37,28,30,0,0,125,35,25,29,33,0,0,122
18,36,18,33,0,0,105,33,22,23,35,0,0,113
21,20,21,24,0,0,86,36,34,16,16,0,0,102
31,27,34,30,0,0,122,27,29,32,31,0,0,119
24,39,24,23,0,0,110,38,35,35,34,0,0,142
20,31,33,35,0,0,119,35,35,31,28,0,0,129
31,23,34,25,8,10,131,34,27,26,26,8,8,129
34,25,24,34,0,0,117,28,20,32,31,0,0,111
28,33,51,17,0,0,129,30,37,30,38,0,0,135
33,35,24,17,5,0,114,26,30,22,31,9,0,118
31,28,30,21,0,0,110,18,33,23,30,0,0,104
38,40,36,33,0,0,147,39,40,35,29,0,0,143
43,25,28,32,0,0,128,30,33,29,38,0,0,130
34,27,27,25,0,0,113,29,29,25,35,0,0,118
32,27,20,29,0,0,108,29,30,38,26,0,0,123
29,24,36,30,0,0,119,26,32,30,29,0,0,117
36,34,32,32,0,0,134,26,34,32,31,0,0,123
24,34,29,30,0,0,117,27,18,23,26,0,0,94
21,29,37,25,0,0,112,21,45,23,16,0,0,105
27,32,33,26,0,0,118,32,22,24,18,0,0,96
30,34,35,29,0,0,128,40,28,37,32,0,0,137
31,28,27,30,0,0,116,34,25,28,33,0,0,120
21,36,23,23,0,0,103,23,33,26,30,0,0,112
34,24,32,32,0,0,122,28,33,33,26,0,0,120
28,17,27,21,0,0,93,35,25,34,21,0,0,115
26,31,30,17,0,0,104,30,23,29,18,0,0,100
24,19,22,41,0,0,106,24,35,24,30,0,0,113
25,26,36,30,0,0,117,29,23,24,20,0,0,96
21,31,28,21,0,0,101,34,26,44,28,0,0,132
25,24,25,26,0,0,100,17,32,34,25,0,0,108
31,28,34,20,0,0,113,23,27,33,20,0,0,103
27,31,33,24,10,0,125,38,26,34,17,19,0,134
29,35,33,34,0,0,131,28,28,41,27,0,0,124
28,31,34,17,0,0,110,48,29,22,32,0,0,131
20,27,33,33,0,0,113,37,27,23,31,0,0,118
23,30,31,33,0,0,117,30,39,22,31,0,0,122
37,34,25,23,0,0,119,29,27,29,35,0,0,120
24,32,29,29,0,0,114,29,21,25,32,0,0,107
26,33,30,26,0,0,115,27,23,32,37,0,0,119
26,34,37,17,10,0,124,33,35,20,26,9,0,123
38,29,26,27,0,0,120,26,42,30,30,0,0,128
35,27,28,22,0,0,112,31,39,15,37,0,0,122
19,30,25,21,0,0,95,20,27,29,30,0,0,106
32,26,39,22,0,0,119,29,20,32,30,0,0,111
35,34,21,31,0,0,121,30,27,33,25,0,0,115
24,31,23,30,6,0,114,34,24,23,27,18,0,126
37,34,30,33,0,0,134,38,23,28,36,0,0,125
22,32,33,32,0,0,119,32,23,40,16,0,0,111
23,27,33,25,0,0,108,27,29,21,35,0,0,112
26,23,28,34,5,0,116,28,22,30,31,14,0,125
32,31,24,23,0,0,110,22,22,28,24,0,0,96
31,36,29,32,0,0,128,32,27,36,24,0,0,119
30,31,37,24,0,0,122,30,39,18,33,0,0,120
25,27,29,33,0,0,114,35,24,30,19,0,0,108
19,31,19,24,0,0,93,27,28,26,31,0,0,112
25,29,19,37,0,0,110,42,32,35,18,0,0,127
29,23,26,24,0,0,102,19,28,24,19,0,0,90
31,31,23,27,0,0,112,27,32,27,22,0,0,108
20,29,19,29,0,0,97,38,29,24,26,0,0,117
40,36,30,30,0,0,136,29,23,33,30,0,0,115
29,20,36,19,0,0,104,25,25,21,17,0,0,88
26,31,33,25,0,0,115,33,23,34,29,0,0,119
29,26,25,29,0,0,109,31,31,23,26,0,0,111
21,37,30,24,0,0,112,43,32,23,25,0,0,123
27,26,37,43,0,0,133,32,30,25,37,0,0,124
30,33,35,22,0,0,120,27,21,28,28,0,0,104
20,25,27,25,0,0,97,38,23,33,23,0,0,117
30,26,36,18,0,0,110,49,23,26,27,0,0,125
39,36,23,25,0,0,123,24,16,35,33,0,0,108
33,29,20,25,0,0,107,24,28,38,31,0,0,121
29,32,28,25,0,0,114,38,29,31,34,0,0,132
29,28,28,31,0,0,116,24,24,36,20,0,0,104
20,29,42,32,0,0,123,33,22,26,26,0,0,107
29,26,29,34,0,0,118,24,36,23,26,0,0,109
27,24,26,42,0,0,119,29,34,42,33,0,0,138
25,23,37,32,0,0,117,30,28,22,34,0,0,114
19,29,26,36,0,0,110,31,31,21,31,0,0,114
23,21,33,27,0,0,104,23,20,28,31,0,0,102
28,32,28,33,16,0,137,29,33,32,27,7,0,128
23,35,35,33,0,0,126,28,33,38,35,0,0,134
29,29,28,33,0,0,119,28,36,22,14,0,0,100
24,30,28,19,0,0,101,24,17,30,25,0,0,96
28,31,28,24,0,0,111,29,35,29,35,0,0,128
30,25,49,35,0,0,139,40,24,37,22,0,0,123
31,27,27,28,0,0,113,30,33,31,22,0,0,116
31,35,26,29,0,0,121,29,25,13,15,0,0,82
31,35,30,23,0,0,119,39,32,33,23,0,0,127
24,20,30,20,0,0,94,31,30,23,33,0,0,117
32,27,31,23,10,8,131,28,26,26,33,10,16,139
26,28,36,22,0,0,112,31,18,31,34,0,0,114
26,20,35,28,17,0,126,35,34,24,16,11,0,120
32,31,26,37,0,0,126,24,24,22,42,0,0,112
29,33,27,22,0,0,111,33,21,26,30,0,0,110
28,39,24,19,0,0,110,36,26,29,25,0,0,116
31,26,17,39,0,0,113,30,25,27,26,0,0,108
34,38,34,35,0,0,141,24,37,34,26,0,0,121
26,32,27,22,0,0,107,32,34,28,28,0,0,122
19,26,32,22,0,0,99,33,37,20,23,0,0,113
23,36,41,19,0,0,119,33,38,33,29,0,0,133
37,34,33,28,0,0,132,33,27,32,26,0,0,118
34,30,27,26,0,0,117,24,33,31,30,0,0,118
33,30,28,17,0,0,108,21,27,23,31,0,0,102
31,38,27,24,0,0,120,25,32,33,34,0,0,124
40,43,20,15,0,0,118,34,27,39,26,0,0,126
26,26,22,38,0,0,112,29,18,34,19,0,0,100
38,26,28,25,0,0,117,28,16,34,29,0,0,107
29,27,39,16,0,0,111,33,25,31,29,0,0,118
36,23,34,24,0,0,117,30,25,28,19,0,0,102
25,24,32,24,0,0,105,28,31,25,27,0,0,111
40,26,22,21,0,0,109,22,36,27,30,0,0,115
17,27,25,22,8,10,109,22,18,28,23,8,6,105
42,37,30,31,0,0,140,32,38,38,26,0,0,134
26,29,29,37,0,0,121,21,29,30,28,0,0,108
28,32,36,12,0,0,108,30,27,26,29,0,0,112
19,33,43,25,0,0,120,40,28,27,33,0,0,128
25,31,32,24,0,0,112,26,34,27,35,0,0,122
32,27,19,29,0,0,107,38,28,33,30,0,0,129
23,38,33,21,0,0,115,30,25,23,31,0,0,109
16,23,26,19,0,0,84,27,37,27,28,0,0,119
30,30,40,32,0,0,132,32,22,31,24,0,0,109
23,33,24,21,0,0,101,22,29,30,19,0,0,100
31,24,39,24,0,0,118,29,28,16,31,0,0,104
30,35,31,31,0,0,127,33,30,30,32,0,0,125
32,29,25,34,0,0,120,31,33,28,35,0,0,127
36,22,25,35,0,0,118,26,26,26,36,0,0,114
36,40,20,20,0,0,116,23,25,28,15,0,0,91
34,30,32,29,0,0,125,37,38,26,29,0,0,130
28,23,21,22,0,0,94,33,33,34,30,0,0,130
40,22,35,27,0,0,124,39,28,27,31,0,0,125
29,39,23,36,0,0,127,34,22,32,27,0,0,115
26,26,33,26,0,0,111,23,36,29,34,0,0,122
22,23,30,31,0,0,106,24,29,22,36,0,0,111
31,29,25,31,0,0,116,33,28,30,23,0,0,114
24,33,24,15,0,0,96,37,25,26,27,0,0,115
29,25,26,25,0,0,105,36,18,38,35,0,0,127
32,23,21,19,0,0,95,34,26,32,28,0,0,120
26,36,36,26,0,0,124,33,33,33,37,0,0,136
26,26,21,24,0,0,97,38,34,20,26,0,0,118
30,22,32,30,0,0,114,42,41,36,32,0,0,151
37,32,26,22,0,0,117,26,29,32,22,0,0,109
40,32,43,29,0,0,144,25,33,27,31,0,0,116
27,26,35,24,0,0,112,23,32,24,41,0,0,120
26,35,33,30,0,0,124,26,19,27,24,0,0,96
30,37,26,34,0,0,127,24,32,45,34,0,0,135
25,41,26,19,0,0,111,41,33,19,23,0,0,116
35,39,24,32,0,0,130,39,33,33,38,0,0,143
28,37,39,25,0,0,129,36,33,18,13,0,0,100
38,28,19,21,0,0,106,37,26,34,32,0,0,129
24,29,30,22,0,0,105,26,32,31,36,0,0,125
26,35,17,35,0,0,113,32,23,35,31,0,0,121
37,31,31,32,0,0,131,26,30,29,25,0,0,110
16,32,24,32,0,0,104,30,25,26,29,0,0,110
29,34,28,27,0,0,118,26,29,23,30,0,0,108
34,27,35,27,0,0,123,27,29,33,30,0,0,119
32,26,19,16,0,0,93,30,38,28,41,0,0,137
22,21,37,11,0,0,91,33,27,25,23,0,0,108
25,26,23,32,0,0,106,24,36,32,27,0,0,119
21,25,38,20,0,0,104,37,26,24,27,0,0,114
25,43,28,22,0,0,118,37,25,32,18,0,0,112
29,24,24,22,0,0,99,29,26,18,23,0,0,96
31,26,37,32,0,0,126,27,24,39,27,0,0,117
29,30,40,28,0,0,127,27,20,27,30,0,0,104
33,28,29,25,0,0,115,36,30,36,35,0,0,137
37,20,27,33,0,0,117,26,26,29,22,0,0,103
18,39,20,34,0,0,111,25,36,30,25,0,0,116
34,24,31,35,0,0,124,14,21,20,35,0,0,90
34,23,29,33,0,0,119,25,33,27,30,0,0,115
32,23,22,35,0,0,112,27,35,37,25,0,0,124
23,28,27,33,0,0,111,29,35,35,31,0,0,130
24,27,33,34,0,0,118,24,35,35,26,0,0,120
23,24,20,25,0,0,92,24,29,31,22,0,0,106
15,29,29,35,0,0,108,32,27,28,26,0,0,113
26,31,36,44,0,0,137,23,45,31,35,0,0,134
36,27,26,20,0,0,109,25,21,39,35,0,0,120
34,39,46,30,0,0,149,30,39,38,29,0,0,136
25,30,32,27,0,0,114,30,24,32,37,0,0,123
23,23,30,16,0,0,92,19,29,28,25,0,0,101
37,25,29,17,0,0,108,28,29,32,27,0,0,116
31,28,26,36,0,0,121,20,31,25,34,0,0,110
29,41,35,36,0,0,141,30,34,41,27,0,0,132
26,30,24,26,0,0,106,26,28,30,23,0,0,107
36,28,29,35,0,0,128,33,29,26,29,0,0,117
24,27,23,26,0,0,100,25,23,33,26,0,0,107
19,31,33,37,0,0,120,20,26,18,16,0,0,80
34,41,39,26,0,0,140,26,21,27,25,0,0,99
21,29,32,25,0,0,107,17,23,30,18,0,0,88
31,31,28,31,0,0,121,23,23,31,14,0,0,91
32,29,33,23,0,0,117,36,29,25,31,0,0,121
30,27,29,24,0,0,110,31,46,22,18,0,0,117
24,36,25,31,0,0,116,32,31,33,13,0,0,109
29,22,27,36,0,0,114,27,30,36,29,0,0,122
33,22,24,28,0,0,107,25,34,42,23,0,0,124
42,37,26,25,0,0,130,47,25,30,14,0,0,116
28,33,31,23,0,0,115,31,27,33,30,0,0,121
34,17,21,22,0,0,94,21,34,31,22,0,0,108
27,28,35,33,0,0,123,29,36,18,28,0,0,111
26,25,37,27,0,0,115,23,31,33,43,0,0,130
36,35,33,34,0,0,138,27,32,30,25,0,0,114
20,20,34,19,0,0,93,32,28,24,16,0,0,100
31,33,32,26,0,0,122,44,32,26,27,0,0,129
31,25,34,24,0,0,114,21,34,36,31,0,0,122
35,32,34,27,0,0,128,25,27,37,19,0,0,108
17,25,26,42,0,0,110,30,23,32,26,0,0,111
36,32,16,23,0,0,107,25,28,40,35,0,0,128
31,25,26,25,0,0,107,29,33,24,19,0,0,105
29,37,25,32,7,0,130,37,33,24,29,9,0,132
31,30,18,30,0,0,109,34,19,33,32,0,0,118
29,15,24,34,0,0,102,34,29,28,37,0,0,128
32,31,33,27,19,0,142,30,28,34,31,11,0,134
35,35,31,33,0,0,134,21,39,23,26,0,0,109
27,42,29,30,0,0,128,27,28,34,29,0,0,118
28,33,26,18,0,0,105,28,31,27,29,0,0,115
26,27,29,22,0,0,104,41,28,27,21,0,0,117
36,25,26,23,0,0,110,26,32,31,23,0,0,112
25,36,33,26,0,0,120,29,20,26,25,0,0,100
31,28,21,38,0,0,118,27,25,27,26,0,0,105
23,35,35,24,0,0,117,29,30,32,22,0,0,113
32,43,39,26,0,0,140,29,33,35,31,0,0,128
31,20,26,30,0,0,107,24,30,24,24,0,0,102
36,29,25,33,0,0,123,26,27,27,25,0,0,105
30,29,26,18,0,0,103,31,25,30,38,0,0,124
25,37,33,14,0,0,109,41,25,30,23,0,0,119
25,40,31,25,0,0,121,22,32,26,23,0,0,103
22,24,21,34,0,0,101,28,25,19,31,0,0,103
34,34,29,27,11,0,135,33,24,36,31,9,0,133
39,40,27,19,0,0,125,36,33,33,34,0,0,136
25,26,25,18,0,0,94,42,27,28,18,0,0,115
47,27,22,27,0,0,123,34,23,33,18,0,0,108
38,32,35,33,0,0,138,29,38,31,31,0,0,129
32,28,30,26,0,0,116,33,34,39,28,0,0,134
28,16,28,21,0,0,93,31,25,23,18,0,0,97
21,30,25,16,0,0,92,28,21,30,26,0,0,105
34,35,21,34,7,0,131,32,20,33,39,14,0,138
27,44,21,27,0,0,119,28,32,32,31,0,0,123
31,21,30,36,0,0,118,37,34,22,32,0,0,125
33,34,28,23,0,0,118,42,15,16,21,0,0,94
41,26,29,33,0,0,129,31,15,32,23,0,0,101
37,24,39,27,0,0,127,32,37,29,31,0,0,129
32,23,29,30,0,0,114,25,27,24,22,0,0,98
25,30,31,29,0,0,115,27,29,33,30,0,0,119
25,30,30,27,0,0,112,26,23,24,36,0,0,109
35,38,23,26,0,0,122,27,30,30,28,0,0,115
23,28,20,37,0,0,108,26,27,36,25,0,0,114
32,21,33,33,17,0,136,31,32,27,29,12,0,131
16,24,33,29,0,0,102,34,34,27,26,0,0,121
23,16,23,22,0,0,84,27,31,20,23,0,0,101
36,35,37,29,0,0,137,31,41,15,27,0,0,114
30,30,23,22,0,0,105,27,33,23,30,0,0,113
26,28,31,30,0,0,115,29,38,24,21,0,0,112
32,21,33,33,0,0,119,16,32,25,24,0,0,97
34,28,27,18,0,0,107,30,31,35,25,0,0,121
19,36,40,19,0,0,114,32,26,31,29,0,0,118
33,37,26,29,0,0,125,26,38,45,27,0,0,136
35,45,39,32,0,0,151,35,33,23,40,0,0,131
31,33,26,24,0,0,114,29,32,39,20,0,0,120
36,25,39,34,0,0,134,21,32,39,13,0,0,105
25,21,18,17,0,0,81,26,23,18,36,0,0,103
17,32,21,36,0,0,106,25,29,21,20,0,0,95
24,26,35,25,0,0,110,23,29,32,39,0,0,123
41,32,27,41,0,0,141,45,26,36,29,0,0,136
26,29,24,26,0,0,105,35,32,28,26,0,0,121
31,24,32,27,0,0,114,39,28,18,24,0,0,109
42,29,37,30,0,0,138,14,45,32,26,0,0,117
43,24,14,14,0,0,95,26,33,24,26,0,0,109
25,31,39,22,0,0,117,31,34,34,29,0,0,128
30,25,30,23,0,0,108,18,29,36,30,0,0,113
24,25,24,27,0,0,100,20,27,38,30,0,0,115
19,29,34,37,0,0,119,28,25,33,28,0,0,114
55,29,34,39,0,0,157,27,26,20,28,0,0,101
36,29,26,25,0,0,116,27,23,28,27,0,0,105
28,32,26,12,4,0,102,22,27,30,19,10,0,108
23,24,25,37,0,0,109,28,30,23,24,0,0,105
32,25,39,27,0,0,123,29,34,24,31,0,0,118
21,23,24,23,0,0,91,29,20,18,35,0,0,102
23,24,31,17,0,0,95,24,33,38,25,0,0,120
25,33,23,20,0,0,101,30,37,26,28,0,0,121
19,25,31,24,0,0,99,29,45,20,18,0,0,112
30,20,28,23,0,0,101,24,21,25,27,0,0,97
29,32,29,33,0,0,123,29,26,36,35,0,0,126
32,27,37,32,0,0,128,27,38,25,22,0,0,112
33,35,34,28,0,0,130,24,31,33,29,0,0,117
30,29,22,34,0,0,115,18,36,27,29,0,0,110
23,21,14,22,0,0,80,26,29,32,22,0,0,109
25,24,14,21,0,0,84,25,19,24,28,0,0,96
23,29,23,31,0,0,106,17,41,25,31,0,0,114
25,24,32,25,0,0,106,28,33,29,29,0,0,119
22,17,21,30,0,0,90,25,34,23,25,0,0,107
29,30,28,22,0,0,109,24,35,33,31,0,0,123
19,25,27,22,0,0,93,30,29,24,20,0,0,103
28,27,30,37,0,0,122,35,46,37,20,0,0,138
22,27,40,24,0,0,113,31,33,23,35,0,0,122
32,26,18,26,0,0,102,28,19,35,15,0,0,97
20,21,31,25,0,0,97,29,24,31,30,0,0,114
27,27,40,35,0,0,129,27,24,34,39,0,0,124
37,30,26,29,0,0,122,33,41,26,30,0,0,130
17,15,23,24,0,0,79,17,28,27,27,0,0,99
28,33,33,26,0,0,120,28,27,33,23,0,0,111
22,18,26,30,0,0,96,29,19,15,25,0,0,88
23,25,35,29,0,0,112,30,17,31,22,0,0,100
21,32,26,20,0,0,99,29,37,28,27,0,0,121
9,28,31,33,0,0,101,35,18,35,23,0,0,111
23,22,26,22,0,0,93,30,24,19,29,0,0,102
32,37,23,33,0,0,125,31,34,37,24,0,0,126
35,30,27,37,0,0,129,25,28,34,34,0,0,121
22,30,22,22,12,0,108,23,25,32,16,18,0,114
33,24,32,25,0,0,114,28,22,28,41,0,0,119
23,29,31,21,7,0,111,29,25,27,23,13,0,117
30,28,24,37,0,0,119,27,39,26,25,0,0,117
29,18,30,32,0,0,109,22,26,29,35,0,0,112
30,40,24,36,0,0,130,32,29,50,25,0,0,136
33,28,26,19,0,0,106,26,25,24,20,0,0,95
24,28,24,23,0,0,99,38,23,33,22,0,0,116
36,27,23,32,10,0,128,33,36,33,16,8,0,126
33,27,39,24,0,0,123,36,20,34,26,0,0,116
35,33,30,30,0,0,128,34,33,33,20,0,0,120
23,35,32,28,0,0,118,25,26,29,19,0,0,99
20,22,25,18,0,0,85,31,28,41,25,0,0,125
32,19,30,26,0,0,107,31,37,26,31,0,0,125
21,29,31,27,0,0,108,32,23,20,26,0,0,101
30,26,35,29,0,0,120,31,27,23,19,0,0,100
31,32,24,32,0,0,119,38,28,21,28,0,0,115
21,21,31,14,0,0,87,18,22,30,27,0,0,97
29,25,23,28,0,0,105,31,20,25,35,0,0,111
29,36,31,21,0,0,117,31,33,24,24,0,0,112
22,27,16,22,0,0,87,28,29,35,29,0,0,121
33,23,24,20,0,0,100,26,41,43,17,0,0,127
28,29,31,26,0,0,114,29,21,27,25,0,0,102
31,21,36,26,0,0,114,29,38,23,31,0,0,121
21,23,26,16,0,0,86,29,29,29,18,0,0,105
30,18,20,29,0,0,97,23,36,27,41,0,0,127
19,31,33,24,8,0,115,27,32,33,15,9,0,116
34,27,31,32,0,0,124,32,31,35,31,0,0,129
30,18,33,20,0,0,101,31,25,34,19,0,0,109
21,31,32,17,0,0,101,22,27,28,27,0,0,104
33,25,30,27,0,0,115,26,23,23,31,0,0,103
24,25,25,28,0,0,102,35,17,39,27,0,0,118
24,23,27,29,0,0,103,14,36,34,28,0,0,112
28,31,23,24,0,0,106,32,38,23,28,0,0,121
29,21,21,24,0,0,95,22,21,30,13,0,0,86
44,37,22,22,0,0,125,26,25,25,24,0,0,100
31,19,21,21,0,0,92,24,27,23,22,0,0,96
26,20,31,24,0,0,101,31,25,35,31,0,0,122
29,23,10,26,0,0,88,23,32,33,24,0,0,112
