29,34,25,29,117,24,39,35,28,126,
22,30,19,38,109,25,34,32,32,123,
28,27,28,26,109,17,40,34,22,113,
36,24,27,27,114,25,27,25,30,107,
20,30,30,27,107,26,33,25,33,117,
32,26,40,32,130,14,36,28,30,108,
23,23,33,29,4,112,25,36,24,23,7,115,
28,31,37,20,116,33,26,27,22,108,
22,35,27,21,105,28,23,25,32,108,
22,30,35,21,108,35,30,22,28,115,
38,30,30,31,129,22,25,28,27,102,
30,23,27,22,102,37,38,19,29,123,
32,30,19,24,105,24,21,31,31,107,
32,19,33,31,115,23,32,29,24,108,
30,17,26,17,90,24,21,18,25,88,
35,21,29,18,103,23,33,21,20,97,
35,26,32,31,124,24,27,34,27,112,
36,34,32,35,137,26,29,30,49,134,
30,20,24,26,100,26,30,21,25,102,
27,27,27,17,98,19,31,30,28,108,
24,28,27,26,105,28,21,29,31,109,
30,29,30,22,111,22,29,26,27,104,
20,32,29,25,106,30,42,31,27,130,
26,36,33,34,129,32,38,30,22,122,
26,29,33,32,12,132,41,23,23,33,6,126,
40,30,28,30,128,34,18,36,35,123,
28,25,26,23,9,111,25,22,28,27,11,113,
19,35,31,29,114,25,26,26,28,105,
35,21,23,36,115,25,27,36,36,124,
36,32,31,27,126,33,35,26,26,120,
34,36,23,35,128,25,29,25,17,96,
33,17,33,26,109,38,33,21,20,112,
23,25,31,26,105,41,26,31,27,125,
17,19,35,25,96,39,25,35,38,137,
29,26,30,32,117,28,27,33,34,122,
29,23,34,25,111,26,29,25,29,109,
32,23,23,28,106,24,24,35,21,104,
22,37,45,22,126,30,25,29,25,109,
31,20,25,27,4,107,30,27,26,20,14,117,
26,37,30,17,12,122,24,29,31,26,11,121,
31,22,29,34,116,18,26,30,32,106,
36,35,23,31,125,39,50,24,17,130,
33,28,25,26,112,18,23,31,23,95,
23,23,30,30,106,33,31,26,30,120,
27,21,23,27,98,23,20,33,14,90,
28,31,23,20,102,34,31,31,19,115,
39,15,25,23,102,30,35,35,20,120,
18,27,28,35,108,21,30,26,37,114,
34,35,28,27,124,39,25,45,25,134,
39,28,36,12,115,28,29,14,35,106,
31,30,25,24,110,23,32,44,36,135,
25,24,26,24,99,28,28,29,35,120,
31,33,25,22,111,40,26,21,26,113,
18,25,25,26,94,23,26,35,24,108,
29,37,20,19,105,37,35,33,29,134,
24,26,19,23,92,30,24,19,30,103,
36,26,27,29,118,32,29,28,24,113,
20,35,21,23,99,25,18,35,32,110,
30,32,28,32,9,131,32,37,29,24,12,134,
27,26,26,30,109,35,28,26,30,119,
27,30,36,16,109,38,38,27,21,124,
28,25,41,28,122,39,29,34,32,134,
21,28,26,26,101,22,39,28,20,109,
22,32,17,28,99,26,28,32,24,110,
28,33,33,25,119,31,25,25,17,98,
30,31,29,22,17,129,23,36,25,28,13,125,
24,36,27,23,110,34,19,36,29,118,
30,29,28,23,110,31,32,29,31,123,
32,31,31,31,125,28,28,27,27,110,
35,34,37,30,136,29,38,27,18,112,
19,11,23,40,93,22,29,31,31,113,
33,29,33,19,18,132,34,41,24,15,9,123,
28,37,16,31,112,26,22,22,20,90,
36,39,26,26,127,28,32,30,27,117,
24,29,32,23,108,26,33,37,23,119,
25,27,23,27,102,28,24,26,33,111,
29,31,34,30,124,36,26,32,35,129,
25,25,28,23,101,35,28,26,28,117,
27,25,31,28,111,21,36,36,31,124,
23,35,24,29,111,32,37,27,29,125,
23,26,33,31,113,32,39,19,29,119,
23,27,33,24,6,113,34,28,18,27,13,120,
26,37,29,33,125,26,36,28,26,116,
37,27,26,24,114,22,34,31,22,109,
30,21,33,31,115,32,27,32,32,123,
27,19,26,27,18,117,25,26,20,28,12,111,
30,24,37,32,123,24,38,33,29,124,
18,34,26,34,112,25,27,15,24,91,
15,32,21,26,94,34,24,29,25,112,
30,29,34,15,108,35,27,22,37,121,
37,18,36,23,114,29,34,37,28,128,
23,24,23,28,98,26,31,28,22,107,
34,26,23,22,105,29,31,28,26,114,
24,32,30,23,109,29,36,25,34,124,
31,20,34,25,110,26,29,38,28,121,
24,28,37,26,115,34,33,18,23,108,
30,22,34,32,118,28,24,21,38,111,
18,36,31,24,109,33,28,31,24,116,
28,25,27,29,109,34,30,31,44,139,
23,29,25,31,108,34,26,28,22,110,
26,18,30,31,105,23,38,36,24,121,
23,29,24,17,93,30,21,22,22,95,
25,27,25,31,108,27,31,22,19,99,
24,32,38,15,109,33,25,28,30,116,
32,34,22,20,108,33,30,22,31,116,
20,27,26,34,107,24,30,30,32,116,
31,26,34,30,121,25,26,39,21,111,
27,29,20,31,6,113,35,15,33,24,7,114,
32,19,25,31,107,33,20,24,33,110,
21,36,32,23,112,32,33,10,24,99,
26,26,18,18,88,27,34,23,22,106,
34,22,30,23,109,24,29,26,22,101,
26,21,21,23,91,31,25,29,31,116,
32,32,40,39,143,31,18,21,30,100,
35,15,28,22,100,23,24,27,29,103,
30,22,26,33,111,23,22,27,34,106,
27,17,35,32,6,117,23,33,26,29,9,120,
30,35,33,31,129,30,23,43,34,130,
42,29,22,29,122,29,28,38,15,110,
24,33,33,22,112,21,18,29,20,88,
29,21,27,22,99,28,34,18,21,101,
21,37,16,32,106,22,31,30,21,104,
38,31,27,32,128,28,29,13,16,86,
31,26,30,32,119,26,37,30,30,123,
24,23,22,30,99,41,30,33,26,130,
28,26,28,31,113,18,40,28,20,106,
29,28,24,29,110,31,31,34,15,111,
27,27,25,26,105,26,35,27,26,114,
34,27,34,20,115,26,28,30,18,102,
25,34,27,22,108,28,21,31,26,106,
40,35,25,30,130,34,28,33,21,116,
25,22,36,23,20,126,33,32,12,29,17,123,
30,22,17,29,98,21,23,26,24,94,
28,24,33,24,12,121,29,31,28,21,15,124,
32,35,34,32,133,29,37,30,22,118,
34,19,25,16,94,34,33,26,15,108,
34,15,34,34,117,40,28,35,26,129,
27,24,25,25,101,40,30,29,27,126,
26,14,21,21,82,35,26,23,18,102,
30,28,29,27,114,36,28,16,20,100,
25,18,31,23,97,24,33,24,22,103,
30,19,33,22,104,21,34,28,30,113,
29,34,21,26,110,29,27,29,17,102,
26,20,30,32,108,18,30,24,28,100,
33,38,29,34,134,30,35,23,39,127,
33,30,22,18,103,28,20,36,28,112,
30,25,36,31,122,32,26,42,29,129,
20,27,23,18,88,33,23,19,25,100,
36,22,22,18,98,25,27,37,28,117,
28,25,20,37,110,28,32,21,26,107,
27,26,17,27,97,30,28,28,25,111,
28,37,19,25,109,34,20,31,21,106,
38,38,27,17,120,29,23,28,27,107,
28,37,29,21,115,28,34,27,20,109,
34,16,23,21,94,29,24,19,24,96,
31,36,21,25,113,29,26,24,37,116,
34,37,27,18,116,42,34,39,24,139,
37,27,23,30,117,31,33,24,31,119,
28,26,20,13,87,24,26,23,21,94,
25,33,28,19,105,30,23,26,16,95,
35,21,33,33,122,27,43,25,24,119,
26,37,22,40,125,22,32,36,29,119,
21,28,30,33,112,29,34,32,33,128,
22,22,27,14,85,38,31,23,20,112,
37,17,28,27,109,29,28,29,30,116,
22,30,27,36,115,22,28,32,29,111,
39,30,35,25,129,25,26,31,35,117,
27,28,29,35,7,10,136,27,28,32,32,7,6,132,
38,28,23,23,12,124,32,27,35,18,10,122,
21,31,23,26,101,38,16,33,27,114,
29,29,35,27,120,34,35,28,30,127,
34,27,22,22,105,28,30,29,26,113,
20,22,24,29,95,29,17,34,24,104,
27,23,23,31,8,112,32,26,27,19,13,117,
27,24,27,28,106,27,30,17,21,95,
25,32,34,21,112,33,33,31,34,131,
23,29,22,23,97,30,28,29,27,114,
26,32,22,32,112,30,38,26,27,121,
24,32,29,28,113,29,41,36,26,132,
27,19,30,17,93,31,23,29,28,111,
30,33,21,19,103,33,39,24,18,114,
25,27,25,24,101,25,23,26,32,106,
23,33,31,33,120,23,37,28,26,114,
24,30,21,35,110,19,31,21,24,95,
30,25,29,28,112,28,33,31,29,121,
30,25,34,28,117,29,28,24,27,108,
26,39,25,14,104,28,24,30,36,118,
24,27,33,25,109,37,30,32,22,121,
33,26,25,31,115,34,23,45,30,132,
25,32,31,24,112,35,24,26,32,117,
26,24,37,19,106,34,29,23,33,119,
36,43,43,23,145,48,25,33,29,135,
40,27,37,25,129,20,30,34,40,124,
19,32,23,18,92,23,32,27,20,102,
30,27,21,20,98,26,25,27,27,105,
32,30,35,29,126,20,27,29,27,103,
39,23,29,24,115,26,38,34,24,122,
22,24,31,26,103,26,29,25,36,116,
27,31,30,27,115,23,28,26,34,111,
31,27,26,28,112,23,22,24,36,105,
35,34,27,26,122,32,30,27,37,126,
31,26,34,21,112,35,23,26,29,113,
31,27,31,33,122,23,23,32,28,106,
29,34,31,27,121,24,26,30,26,106,
26,19,23,27,95,33,28,38,33,132,
35,25,27,15,102,32,27,30,24,113,
15,17,33,36,101,30,24,15,34,103,
23,38,22,35,118,27,31,27,26,111,
29,27,33,21,110,30,32,31,24,117,
30,24,28,39,121,36,37,42,38,153,
27,33,30,35,125,27,36,27,23,113,
42,32,24,28,126,24,25,31,28,108,
29,25,35,32,121,37,30,20,33,120,
30,32,35,29,126,18,35,25,23,101,
31,29,19,25,104,27,27,30,28,112,
37,23,18,20,98,34,27,34,18,113,
28,25,25,32,110,32,26,37,29,124,
31,26,19,25,101,28,23,23,18,92,
30,25,25,26,106,27,27,30,19,103,
33,32,24,30,119,36,36,31,27,130,
28,29,28,24,109,28,33,21,25,107,
28,28,26,30,112,37,26,26,41,130,
23,27,17,24,91,15,27,26,28,96,
31,38,19,16,2,106,33,24,24,23,3,107,
14,32,24,35,15,2,122,28,30,24,23,15,12,132,
34,28,22,18,102,24,31,34,21,110,
37,29,21,21,108,24,28,27,28,107,
10,35,26,28,99,25,25,20,21,91,
28,31,24,27,110,33,30,29,29,121,
27,28,28,16,99,29,44,32,22,127,
40,27,22,28,117,25,32,21,31,109,
35,31,39,28,133,42,32,33,27,134,
19,31,24,27,101,35,26,26,24,111,
37,27,31,26,121,30,38,28,32,128,
31,31,27,22,11,122,29,26,27,29,13,124,
28,27,29,29,113,22,29,38,25,114,
33,30,34,15,112,23,28,33,25,109,
20,38,29,31,118,23,28,28,34,113,
22,26,21,28,97,40,24,27,28,119,
22,31,22,20,95,28,27,35,26,116,
33,37,32,27,129,38,30,34,35,137,
27,28,24,23,102,35,24,18,29,106,
29,33,31,22,115,28,29,39,31,127,
27,15,22,23,87,28,31,36,18,113,
40,21,36,30,127,28,37,29,26,120,
25,30,24,19,98,25,31,18,23,97,
20,28,19,25,92,34,32,29,28,123,
26,33,23,20,102,38,26,21,29,114,
28,17,22,35,102,27,27,32,37,123,
23,27,29,28,107,28,35,32,26,121,
32,29,18,32,111,30,33,30,26,119,
33,27,19,22,101,30,17,37,21,105,
16,25,24,18,83,35,30,32,31,128,
38,31,29,31,129,34,24,29,32,119,
24,32,37,21,114,34,32,22,33,121,
26,31,25,24,106,33,30,22,30,115,
28,36,24,25,113,31,28,17,33,109,
28,30,25,27,110,29,28,24,27,108,
22,33,24,26,105,26,27,33,29,115,
33,21,21,26,101,21,32,26,28,107,
21,27,27,21,96,28,29,30,27,114,
29,24,34,28,115,21,27,29,24,101,
26,31,31,18,106,35,37,25,18,115,
23,26,36,27,112,34,36,31,24,125,
26,17,37,25,105,28,32,23,30,113,
38,14,39,21,112,26,25,25,22,98,
32,29,29,28,118,33,29,21,30,113,
38,31,15,36,11,131,21,42,34,23,6,126,
29,37,38,25,129,19,28,38,25,110,
30,36,32,27,125,25,29,36,26,116,
29,18,35,25,107,32,34,32,26,124,
34,28,21,25,108,29,23,39,19,110,
24,28,30,25,107,29,27,20,23,99,
25,37,30,24,16,132,31,30,25,30,13,129,
22,40,22,20,104,36,28,30,28,122,
33,39,32,18,122,38,31,25,34,128,
35,30,29,23,117,23,34,31,40,128,
25,23,29,34,111,44,24,38,26,132,
38,21,26,22,107,28,28,29,25,110,
30,33,10,29,102,25,27,35,30,117,
30,29,21,30,9,119,32,27,28,23,13,123,
33,26,20,26,105,21,20,34,19,94,
22,32,25,23,102,23,30,31,24,108,
23,28,35,32,118,37,22,38,32,129,
31,33,23,27,114,26,26,25,27,104,
29,23,21,27,100,24,30,27,24,105,
22,22,29,32,105,23,42,30,23,118,
33,37,36,37,143,34,34,29,41,138,
32,22,27,31,112,22,29,27,35,113,
24,33,23,17,97,31,27,26,27,111,
47,29,33,28,137,27,29,33,25,114,
29,28,12,31,100,35,24,23,32,114,
23,28,34,21,106,31,29,21,17,98,
26,29,33,33,121,35,37,41,17,130,
20,31,22,29,102,26,30,22,16,94,
25,29,39,34,127,26,26,31,40,123,
36,31,32,34,133,32,13,26,32,103,
33,29,34,19,115,41,32,31,20,124,
34,21,26,20,101,23,28,30,23,104,
33,25,39,30,127,38,39,32,33,142,
19,36,27,23,105,45,33,43,19,140,
28,23,25,26,102,23,29,35,22,109,
24,19,24,21,88,26,26,28,20,100,
26,24,24,27,101,34,22,25,24,105,
39,29,23,22,113,42,28,36,23,129,
27,26,33,28,114,27,33,20,27,107,
31,32,28,31,122,26,38,20,33,117,
29,27,28,32,116,32,30,31,22,115,
40,30,38,32,140,32,24,21,33,110,
24,30,33,26,113,36,19,37,24,116,
25,28,29,36,118,30,31,34,17,112,
21,27,18,19,85,25,44,21,23,113,
38,32,30,25,125,27,23,26,32,108,
35,25,36,25,121,38,30,34,32,134,
28,25,24,30,107,29,28,23,33,113,
22,25,27,35,109,20,25,26,32,103,
26,22,24,29,101,27,17,31,34,109,
29,18,31,30,108,40,34,28,24,126,
35,42,19,15,111,32,28,28,31,119,
24,23,25,28,100,44,30,22,24,120,
25,18,38,32,113,32,32,42,26,132,
26,34,25,27,112,35,23,36,31,125,
20,28,35,31,114,33,29,44,31,137,
22,40,20,27,109,24,42,31,31,128,
36,24,29,28,8,125,36,25,38,18,14,131,
31,28,29,28,116,36,38,33,10,117,
25,21,35,28,109,28,32,30,27,117,
27,32,22,29,10,120,27,35,25,23,6,116,
17,32,23,33,105,41,31,21,21,114,
25,22,17,32,96,27,27,28,25,107,
33,33,35,32,133,31,27,39,32,129,
30,24,22,33,109,29,35,28,25,117,
26,23,32,36,117,24,28,19,28,99,
27,30,29,36,122,36,28,32,25,121,
24,35,22,38,119,35,40,26,38,139,
33,19,30,29,111,35,28,33,23,119,
20,32,41,28,121,32,27,15,26,100,
38,22,30,33,123,24,14,31,27,96,
30,26,28,21,105,24,21,28,23,96,
32,31,34,38,135,29,28,44,27,128,
22,26,25,35,108,36,28,30,27,121,
23,29,28,21,101,39,29,26,26,120,
40,29,23,24,116,31,29,30,21,111,
31,29,21,25,106,27,32,28,34,121,
35,36,35,27,133,30,11,30,24,95,
35,27,13,28,103,27,23,19,23,92,
40,29,32,21,122,26,31,26,29,112,
16,27,20,18,81,23,23,25,21,92,
27,20,31,23,101,29,33,20,28,110,
33,35,37,25,130,27,23,31,38,119,
24,25,25,26,100,28,26,39,23,116,
28,35,21,35,119,26,28,36,27,117,
30,26,32,21,109,21,24,27,30,102,
27,27,30,37,121,29,30,29,26,114,
27,29,35,25,116,25,37,18,30,110,
30,25,29,24,9,6,123,27,29,34,18,9,15,132,
32,19,26,16,93,27,31,24,19,101,
15,26,34,36,111,33,34,29,34,130,
34,25,30,23,112,21,29,31,23,104,
26,23,34,19,102,27,30,28,31,116,
20,27,31,38,116,25,25,23,23,96,
36,28,27,25,116,29,29,28,29,115,
32,17,29,21,12,111,14,26,31,28,17,116,
28,27,32,29,116,38,35,23,26,122,
20,21,26,22,89,31,22,36,24,113,
31,16,28,38,113,39,31,27,29,126,
22,27,32,30,111,29,23,28,35,115,
25,27,35,15,102,27,30,37,29,123,
29,32,33,19,113,34,34,29,29,126,
17,44,29,25,115,35,28,27,31,121,
28,15,30,25,98,27,29,23,25,104,
35,34,22,32,123,30,36,34,24,124,
31,38,35,21,125,21,21,23,33,98,
28,26,33,23,110,20,36,28,31,115,
29,25,23,32,109,24,27,39,28,118,
30,33,26,32,121,36,28,35,21,120,
22,33,34,32,121,20,29,22,31,102,
33,32,24,22,111,31,38,26,26,121,
25,38,24,22,109,37,30,27,19,113,
30,34,26,26,116,36,32,28,24,120,
31,18,30,27,106,20,29,31,15,95,
20,39,24,37,2,122,31,30,32,27,13,133,
27,26,25,25,103,34,27,37,16,114,
27,25,30,35,117,26,29,40,33,128,
28,33,21,36,118,24,22,33,29,108,
32,20,21,33,106,33,15,36,21,105,
25,34,27,29,115,29,28,27,27,111,
40,29,26,41,136,38,38,24,33,133,
28,32,26,28,114,29,34,21,23,107,
22,24,26,30,102,28,31,23,28,110,
30,23,32,30,115,40,42,31,31,144,
25,38,20,24,107,33,35,27,28,123,
26,26,38,20,110,28,33,31,23,115,
27,39,26,26,118,32,33,29,30,124,
36,22,35,24,7,124,29,28,41,19,12,129,
32,29,30,33,124,26,23,41,27,117,
22,28,30,19,99,36,30,29,17,112,
19,20,36,24,99,18,29,35,29,111,
21,33,33,26,113,20,41,35,35,131,
27,23,28,32,12,122,22,36,27,25,13,123,
25,23,31,13,92,19,31,24,23,97,
26,21,20,20,87,19,23,22,18,82,
29,33,32,18,112,25,30,28,17,100,
29,22,25,27,103,35,27,40,26,128,
28,24,38,24,114,23,43,31,24,121,
27,22,29,33,111,29,36,27,20,112,
27,32,25,28,112,33,37,36,27,133,
25,22,25,21,93,29,27,32,25,113,
32,23,28,20,103,39,41,21,22,123,
27,25,25,34,111,38,26,31,33,128,
20,15,32,30,97,27,27,30,27,111,
30,15,26,29,100,29,23,39,30,121,
37,28,23,22,12,122,24,26,32,28,8,118,
35,38,34,20,14,141,33,36,28,30,7,134,
26,28,33,32,119,27,47,19,32,125,
22,40,32,30,124,50,26,29,30,135,
29,35,28,25,11,128,28,27,33,29,3,120,
23,36,29,36,124,31,31,32,29,123,
31,33,22,24,110,31,21,32,24,108,
39,34,24,31,128,28,29,32,23,112,
26,34,23,22,105,19,22,27,22,90,
31,36,28,33,128,38,34,30,39,141,
21,22,22,23,88,19,19,29,32,99,
29,37,20,25,111,29,23,33,23,108,
18,23,30,30,101,33,37,47,25,142,
25,37,33,28,6,129,27,31,33,32,9,132,
29,35,25,22,111,18,19,33,25,95,
38,37,23,27,125,24,35,33,14,106,
28,27,38,29,122,29,34,23,27,113,
32,30,26,29,117,28,26,27,28,109,
31,30,33,18,112,29,25,29,35,118,
38,19,24,25,106,33,22,33,30,118,
19,33,36,31,119,29,33,22,32,116,
29,29,29,27,114,32,21,22,16,91,
30,33,25,24,112,28,22,41,19,110,
32,31,22,25,110,31,41,38,20,130,
32,33,23,20,108,33,31,29,33,126,
28,29,18,18,93,20,30,22,30,102,
25,27,28,31,111,28,27,29,17,101,
29,20,26,21,3,99,27,20,20,29,4,100,
33,24,28,22,107,27,24,14,30,95,
22,25,36,14,97,27,29,36,31,123,
21,22,33,33,109,25,39,27,24,115,
34,29,26,25,114,27,19,38,34,118,
26,24,18,27,95,23,18,30,21,92,
29,25,30,25,109,28,25,32,21,106,
21,33,44,26,124,35,36,25,25,121,
36,32,34,24,126,26,28,26,30,110,
34,31,32,29,126,32,39,42,37,150,
25,27,28,35,115,20,35,39,25,119,
29,23,36,29,117,30,36,21,32,119,
21,23,27,28,99,29,33,28,32,122,
23,23,32,21,2,101,22,35,21,21,5,104,
27,38,29,31,125,34,34,36,22,126,
35,25,32,32,124,28,34,14,29,105,
30,14,30,32,106,21,36,37,22,116,
30,36,34,28,128,27,34,29,29,119,
28,30,36,27,121,28,33,33,29,123,
24,20,33,27,104,38,30,31,31,130,
39,27,25,34,125,30,33,29,27,119,
31,30,34,31,126,24,36,25,26,111,
31,21,36,25,113,21,36,20,26,103,
25,31,25,13,94,33,36,31,32,132,
27,26,27,33,113,30,18,30,32,110,
14,26,31,20,91,35,20,29,21,105,
20,22,35,29,106,35,25,33,21,114,
29,22,27,15,93,37,26,29,21,113,
30,31,20,29,110,25,26,26,31,108,
42,29,29,17,117,22,21,42,27,112,
17,34,28,34,113,46,45,18,34,143,
28,35,24,26,113,27,26,27,26,106,
25,29,31,31,116,31,33,23,23,110,
29,22,24,29,104,31,21,22,25,99,
32,22,24,20,98,22,27,29,23,101,
26,32,28,34,120,25,41,40,28,134,
19,21,34,31,105,37,34,26,29,126,
17,29,29,42,117,37,28,29,32,126,
27,39,24,22,112,30,30,33,27,120,
28,33,28,24,113,34,27,33,39,133,
33,30,22,29,114,24,27,34,34,119,
34,29,18,24,105,32,28,35,35,130,
29,27,30,23,109,22,32,34,33,121,
29,18,28,25,100,36,24,25,33,118,
39,30,29,20,118,31,22,25,29,107,
29,29,31,29,118,22,38,32,25,117,
30,31,20,31,112,24,26,34,22,106,
31,25,28,27,111,28,30,24,26,108,
33,31,16,32,16,128,23,23,31,35,13,125,
27,37,16,27,107,32,26,35,27,120,
39,20,38,28,125,20,18,31,31,100,
28,40,34,23,125,27,23,33,28,111,
27,40,30,37,134,31,36,20,43,130,
25,35,35,24,119,37,26,33,16,112,
28,26,21,40,115,21,22,51,30,124,
28,33,25,32,118,36,26,38,39,139,
29,25,30,25,109,33,26,40,24,123,
24,33,27,29,12,125,28,23,30,32,15,128,
34,31,26,34,125,22,27,30,38,117,
31,35,30,32,14,142,36,25,39,28,3,131,
31,25,30,24,110,33,26,34,20,113,
36,28,35,34,133,26,39,24,29,118,
18,20,24,31,93,24,33,33,23,113,
26,30,26,40,122,31,32,33,30,126,
34,33,28,18,113,30,31,40,23,124,
33,32,27,37,129,27,28,28,27,110,
30,26,29,26,111,32,35,27,22,116,
21,28,32,21,102,22,34,36,34,126,
27,27,32,28,114,30,34,32,33,129,
27,33,37,27,124,29,27,26,31,113,
23,42,32,28,125,22,27,31,28,108,
33,27,33,21,114,38,32,25,35,130,
30,33,29,23,6,121,28,27,27,33,11,126,
26,26,26,27,105,37,28,24,21,110,
20,27,32,34,113,32,24,27,23,106,
23,24,30,24,101,27,39,26,29,121,
21,34,29,18,102,36,28,29,34,127,
31,25,27,25,108,30,33,17,27,107,
25,27,26,20,98,33,28,34,17,112,
32,23,27,24,7,113,28,29,22,27,13,119,
28,27,33,30,118,24,25,37,33,119,
37,22,35,13,107,27,27,34,24,112,
40,35,30,21,126,24,38,32,33,127,
30,30,24,29,113,36,21,28,36,121,
34,34,28,30,126,29,35,35,36,135,
26,23,36,25,110,27,33,24,32,116,
30,27,36,26,119,20,23,32,31,106,
29,24,26,36,115,38,26,28,30,122,
30,21,28,35,114,36,29,34,30,129,
27,29,42,21,119,20,27,26,27,100,
23,39,36,32,130,33,34,28,26,121,
24,27,28,25,104,33,20,33,27,113,
25,33,34,26,118,33,27,35,37,132,
34,27,22,31,114,33,17,39,34,123,
27,33,31,25,116,31,36,32,28,127,
19,38,33,29,119,23,37,25,39,124,
25,31,40,16,112,41,19,28,30,118,
27,30,30,38,125,30,30,31,35,126,
22,33,38,37,130,32,30,31,38,131,
28,32,24,19,103,30,25,22,25,102,
32,29,36,26,123,22,27,30,27,106,
27,26,29,26,108,35,14,21,18,88,
32,36,35,23,126,30,34,29,32,125,
25,25,29,22,101,31,22,30,33,116,
28,22,38,28,116,39,25,24,16,104,
38,31,20,26,115,20,23,29,24,96,
31,38,27,30,126,30,33,35,25,123,
28,26,31,26,111,37,25,36,25,123,
26,32,29,21,108,27,32,32,27,118,
34,34,20,30,118,17,33,20,25,95,
11,20,27,25,83,23,31,25,23,102,
22,38,34,27,121,21,24,31,39,115,
34,31,31,34,4,134,27,20,44,39,15,145,
33,24,33,24,114,29,37,25,31,122,
25,27,29,30,111,33,24,27,36,120,
25,22,32,24,103,37,37,34,31,139,
18,26,39,28,111,26,29,32,19,106,
23,30,32,26,111,23,36,31,34,124,
26,27,42,26,11,9,141,38,32,25,26,11,11,143,
27,25,30,24,106,22,39,41,33,135,
34,33,14,29,110,28,21,34,17,100,
28,21,36,28,113,32,29,29,33,123,
33,21,37,26,117,34,40,48,28,150,
35,25,28,29,117,23,28,38,26,115,
40,36,26,29,131,26,21,26,34,107,
14,29,21,24,88,15,18,26,31,90,
28,25,35,27,115,31,39,25,31,126,
28,33,23,36,6,126,27,39,31,23,9,129,
29,26,34,25,114,39,23,32,23,117,
13,26,24,34,7,104,12,26,21,38,4,101,
33,26,26,27,112,40,29,19,33,121,
24,29,32,21,106,29,31,29,24,113,
22,30,21,35,108,45,30,23,21,119,
34,26,31,31,122,26,30,32,31,119,
23,25,30,31,109,32,20,27,33,112,
30,31,30,29,120,30,28,30,29,117,
22,43,27,31,123,20,23,35,37,115,
29,35,25,35,124,20,26,19,30,95,
31,33,31,36,131,23,33,30,28,114,
15,17,27,32,91,32,34,36,20,122,
29,26,27,17,99,26,28,27,27,108,
25,34,40,27,126,30,25,29,28,112,
27,26,35,20,108,28,36,21,17,102,
30,27,24,31,112,26,21,31,30,108,
51,33,28,26,138,28,32,27,22,109,
17,25,38,30,110,35,33,35,24,127,
28,20,28,33,109,31,20,35,35,121,
28,30,24,26,108,26,36,32,27,121,
33,21,25,36,115,37,31,32,28,128,
30,21,27,26,104,23,23,27,23,96,
28,21,33,32,114,37,33,28,32,130,
33,35,25,28,121,30,27,32,27,116,
24,25,40,29,118,28,25,31,42,126,
15,31,35,36,117,34,29,34,30,127,
28,34,30,23,115,29,30,23,19,101,
37,36,36,27,136,38,35,36,25,134,
35,36,29,23,123,27,27,28,29,111,
27,26,21,31,105,34,24,31,28,117,
27,18,34,32,111,15,32,26,43,116,
24,28,38,28,118,23,43,32,25,123,
31,35,13,23,102,30,34,18,19,101,
24,34,19,27,104,33,29,19,15,96,
34,21,28,26,109,33,36,27,24,120,
35,22,23,32,112,26,28,25,19,98,
25,41,19,27,112,26,26,35,21,108,
35,33,32,32,132,37,19,32,24,112,
25,25,23,26,99,28,31,25,23,107,
22,24,27,38,111,22,29,27,29,107,
25,36,31,21,113,35,37,25,24,121,
23,25,31,30,109,29,33,32,28,122,
31,21,32,27,111,41,31,35,29,136,
20,23,32,41,116,27,38,42,40,147,
26,30,32,23,111,31,32,26,23,112,
34,32,28,26,120,35,37,24,36,132,
24,31,29,30,114,31,24,33,28,116,
31,28,39,27,125,26,19,34,34,113,
33,17,32,27,109,20,30,23,33,106,
25,22,31,23,101,31,38,19,25,113,
34,30,23,31,118,31,34,36,34,135,
29,30,21,17,97,25,21,41,13,100,
39,28,22,25,114,19,27,36,23,105,
32,26,27,29,114,35,29,33,28,125,
21,20,40,32,113,37,25,33,24,119,
37,25,35,32,129,32,44,36,23,135,
28,26,21,22,97,34,36,30,26,126,
27,35,33,20,115,31,36,27,41,135,
35,32,34,32,133,35,22,28,29,114,
29,31,24,25,109,31,26,25,16,98,
23,22,28,29,102,14,31,33,30,108,
29,26,33,26,114,38,31,28,27,124,
36,23,23,19,7,11,119,22,26,28,25,7,7,115,
27,24,36,32,119,32,26,33,22,113,
32,27,33,24,116,28,22,33,27,110,
36,19,29,29,113,27,31,31,22,111,
19,31,30,32,112,21,32,23,32,108,
33,41,40,30,144,28,32,29,24,113,
33,39,19,33,124,31,27,32,20,110,
25,24,26,41,116,35,29,28,29,121,
27,29,27,25,108,36,25,27,24,112,
32,25,29,29,115,34,24,23,22,103,
32,34,26,22,114,36,33,43,27,139,
20,25,26,24,95,28,25,24,34,111,
31,31,33,27,122,34,32,19,21,106,
36,32,29,33,130,28,24,27,33,112,
34,35,27,18,114,25,32,22,24,103,
25,29,26,22,102,27,22,28,33,110,
41,25,22,30,118,24,32,29,32,117,
30,26,34,29,119,31,40,35,30,136,
39,23,28,27,117,22,33,25,24,104,
30,33,27,10,100,31,31,29,30,121,
20,42,24,32,118,35,24,33,40,132,
28,20,27,37,112,24,26,30,22,102,
33,30,39,30,132,32,32,26,29,119,
25,29,34,28,116,31,38,25,25,119,
31,23,41,28,123,33,28,37,42,140,
33,24,29,27,113,32,26,25,29,112,
35,31,26,38,130,22,33,31,32,118,
38,38,22,21,119,32,33,28,39,132,
25,25,31,22,103,24,23,31,35,113,
29,27,25,29,13,123,25,34,28,23,11,121,
35,34,24,34,127,33,31,29,25,118,
26,24,30,33,113,38,32,21,30,121,
27,25,35,39,126,27,31,37,30,125,
36,29,23,18,106,29,39,39,29,136,
35,26,37,34,132,37,36,29,38,140,
34,40,23,25,122,44,23,38,25,130,
15,36,17,30,98,27,24,25,30,106,
31,36,22,24,113,34,39,28,21,122,
34,29,27,30,120,27,25,37,21,110,
40,25,33,32,130,37,25,35,25,122,
35,21,32,28,116,22,26,30,27,105,
36,17,30,39,122,31,29,24,33,117,
30,31,30,23,114,31,37,21,26,115,
36,34,28,26,124,23,28,25,22,98,
20,24,29,33,106,36,22,42,26,126,
26,30,25,22,103,36,32,27,31,126,
27,33,35,23,118,30,25,33,34,122,
28,33,29,26,116,39,21,22,29,111,
31,34,28,33,126,24,32,23,29,108,
26,29,34,17,12,118,25,29,28,24,15,121,
37,39,33,17,126,31,35,35,27,128,
29,22,23,38,112,35,30,29,23,117,
26,31,22,26,105,14,20,31,30,95,
30,30,31,19,110,23,33,32,35,123,
38,33,30,23,124,35,33,34,37,139,
33,31,34,22,120,28,31,27,28,114,
19,32,16,23,90,31,29,32,23,115,
41,24,33,33,131,36,36,23,31,126,
28,25,29,29,111,37,24,38,35,134,
28,23,32,34,117,22,33,28,23,106,
23,30,36,32,121,26,23,32,41,122,
32,34,22,25,113,33,26,32,27,118,
26,24,31,25,106,27,30,28,19,104,
26,31,34,27,118,37,33,30,38,138,
25,24,36,37,122,31,34,28,25,118,
26,21,34,21,102,23,27,36,28,114,
26,26,32,20,104,26,24,37,26,113,
27,30,26,24,107,29,30,28,25,112,
27,37,38,27,129,35,39,22,31,127,
22,27,30,33,112,20,34,25,19,98,
32,15,25,24,96,23,18,28,31,100,
22,31,33,30,116,37,25,24,39,125,
27,25,29,20,101,18,29,27,25,99,
18,19,35,38,110,32,30,25,25,112,
28,32,26,34,120,33,39,18,26,116,
33,13,40,35,121,26,45,20,21,112,
49,34,32,35,150,24,31,37,38,130,
23,31,25,19,98,30,25,33,25,113,
21,27,30,22,100,17,40,21,33,111,
26,30,25,33,114,31,25,34,29,119,
24,21,34,23,102,21,37,31,31,120,
38,36,27,26,127,40,34,45,28,147,
33,28,29,10,100,47,19,34,33,133,
33,29,25,23,110,21,25,34,36,116,
30,28,24,13,95,32,18,25,23,98,
27,24,24,28,103,34,19,27,25,105,
28,35,20,16,99,24,23,27,24,98,
32,33,34,28,127,28,32,37,29,126,
15,32,30,20,97,36,22,40,30,128,
37,40,21,35,133,30,24,28,33,115,
29,39,23,29,120,46,27,29,24,126,
41,24,33,35,133,41,34,32,30,137,
25,18,28,37,108,30,28,23,22,103,
27,26,20,26,99,26,32,23,26,107,
26,20,39,26,111,34,18,21,29,102,
39,38,32,28,137,43,34,27,28,132,
22,32,42,24,120,24,29,37,32,122,
31,33,27,33,124,19,47,36,32,134,
24,34,26,29,113,23,27,17,28,95,
30,24,28,22,104,25,28,28,32,113,
26,32,33,19,10,120,34,26,25,25,7,117,
30,28,43,29,130,27,32,31,32,122,
36,19,24,17,96,32,15,30,34,111,
37,37,23,16,113,25,23,26,21,95,
32,22,22,23,99,32,16,21,26,95,
25,32,24,19,100,41,37,26,34,138,
45,40,29,27,141,30,26,43,32,131,
31,22,24,23,100,38,24,25,24,111,
31,28,20,26,105,26,24,23,37,110,
25,29,24,22,100,27,20,31,34,112,
36,26,32,23,117,34,29,35,31,129,
38,35,26,20,119,29,29,38,30,126,
22,27,32,34,115,28,34,26,34,122,
27,32,24,34,117,37,20,29,28,114,
25,35,35,33,128,19,28,34,28,109,
22,36,26,36,120,28,25,28,32,113,
21,38,22,29,110,29,28,33,27,117,
32,27,29,25,113,30,20,24,29,103,
33,22,32,23,18,128,26,22,28,34,8,118,
27,27,27,24,16,121,28,20,33,24,20,125,
23,25,28,24,100,34,32,18,24,108,
37,26,25,35,123,14,30,39,22,105,
28,34,24,31,117,26,32,33,31,122,
32,30,17,21,100,23,27,30,32,112,
15,19,23,42,99,31,33,25,33,122,
19,25,44,22,110,37,25,44,29,135,
17,35,42,25,119,30,32,28,19,109,
16,30,36,22,104,29,29,27,36,121,
24,27,27,25,15,118,17,36,28,22,8,111,
38,25,31,34,128,20,28,37,35,120,
30,33,35,29,127,36,19,32,19,106,
27,30,27,21,105,30,23,30,28,111,
28,25,31,22,106,31,31,20,32,114,
23,37,32,33,125,31,33,35,30,129,
24,31,24,21,100,26,26,27,18,97,
29,23,34,28,15,129,24,29,30,31,9,123,
20,34,31,23,108,32,26,26,19,103,
27,37,26,25,115,34,30,33,27,124,
35,25,24,29,113,31,26,36,29,122,
26,26,32,38,122,32,25,33,22,112,
23,30,25,16,94,37,19,26,23,105,
16,29,27,24,96,46,33,31,29,139,
25,33,28,20,106,34,33,17,28,112,
34,37,22,17,4,114,32,30,20,28,9,119,
30,31,28,30,119,31,23,30,25,109,
25,35,32,36,128,31,34,31,35,131,
26,40,36,30,132,23,24,20,33,100,
30,24,30,28,112,35,32,29,15,111,
26,28,33,26,113,30,37,32,29,128,
22,26,24,32,104,28,23,26,29,106,
29,20,21,28,98,31,22,32,29,114,
22,21,33,30,106,40,30,25,16,111,
35,34,22,26,117,34,36,35,29,134,
24,32,31,18,105,15,34,29,28,106,
30,38,26,18,112,29,40,23,26,118,
27,21,32,24,104,28,32,27,20,107,
19,32,39,34,124,36,33,25,22,116,
24,33,17,32,106,20,24,29,21,94,
20,35,30,32,117,21,27,24,39,111,
27,37,26,37,127,34,23,18,45,120,
26,47,33,31,137,26,35,26,38,125,
32,30,29,24,115,22,28,28,30,108,
44,29,26,24,123,25,30,37,33,125,
32,40,34,20,126,30,31,42,28,131,
30,28,30,28,116,27,22,27,24,100,
36,27,33,19,19,134,28,28,25,34,13,128,
27,43,17,34,121,34,25,33,37,129,
26,36,30,23,115,34,28,32,29,123,
19,34,28,40,121,38,41,44,30,153,
23,35,28,27,113,40,33,29,17,119,
30,22,34,22,108,35,35,27,31,128,
28,34,28,29,119,37,21,27,28,113,
27,35,36,24,122,25,21,38,19,103,
28,31,19,28,106,31,31,24,17,103,
35,18,26,18,97,24,27,25,32,108,
21,22,28,27,98,32,31,31,34,128,
26,26,24,28,104,34,36,34,32,136,
26,34,30,21,111,25,28,19,27,99,
37,29,30,18,114,25,21,26,19,91,
29,26,36,33,124,27,26,35,28,116,
28,31,26,19,104,39,23,28,38,128,
31,34,34,41,140,24,24,40,32,120,
25,35,29,35,124,37,25,23,26,111,
37,16,26,35,114,31,29,44,37,141,
30,28,37,32,127,22,26,23,37,108,
22,18,26,36,102,26,22,21,29,98,
24,33,30,29,116,25,26,30,31,112,
35,24,22,26,107,33,29,29,25,116,
14,25,36,14,89,26,23,23,32,104,
19,29,27,37,112,49,30,31,36,146,
36,40,28,29,133,34,32,33,31,130,
14,26,28,17,85,32,19,25,37,113,
31,30,15,28,104,32,29,27,30,118,
27,28,24,20,99,30,29,27,20,106,
30,33,20,28,111,39,21,29,27,116,
24,30,21,23,98,34,23,31,24,112,
30,28,41,31,130,37,25,35,31,128,
33,44,40,26,143,31,36,21,30,118,
41,19,21,29,110,25,27,26,26,104,
27,40,28,27,122,34,29,32,30,125,
26,29,29,20,104,29,36,24,26,115,
22,25,28,32,107,36,20,37,23,116,
26,24,34,21,105,19,34,26,37,116,
26,24,38,27,115,31,27,23,25,106,
28,26,29,30,12,6,131,19,34,38,22,12,13,138,
30,30,35,22,117,24,23,30,27,104,
36,29,28,15,108,28,31,33,27,119,
24,29,28,35,116,32,39,26,30,127,
28,30,25,39,122,34,27,35,20,116,
32,26,28,21,107,31,38,34,25,128,
29,27,17,22,95,28,30,17,22,97,
38,35,28,17,118,28,28,26,25,107,
33,39,31,35,138,35,33,37,24,129,
45,29,27,21,122,25,31,31,27,114,
22,32,27,38,119,27,24,25,30,106,
26,26,24,25,101,28,32,22,16,98,
27,30,37,25,119,34,26,23,22,105,
19,27,26,25,10,107,29,25,25,18,6,103,
29,28,31,25,113,37,43,24,23,127,
31,29,17,29,106,32,29,32,32,125,
28,28,28,36,120,33,29,25,39,126,
29,20,25,15,89,26,14,29,28,97,
21,30,34,24,109,22,31,26,24,103,
32,32,24,26,14,128,34,28,24,28,19,133,
28,20,33,28,109,26,35,21,37,119,
29,23,25,41,118,31,22,31,35,119,
27,41,28,42,138,36,38,35,35,144,
19,30,32,28,109,34,31,26,26,117,
27,26,36,34,123,33,18,37,29,117,
29,19,30,26,104,32,23,35,33,123,
27,38,24,23,112,36,26,21,25,108,
26,35,22,23,106,32,26,35,31,124,
25,24,27,24,100,21,23,24,23,91,
33,27,16,27,103,25,26,22,27,100,
33,32,35,24,124,23,31,28,39,121,
39,27,27,33,126,29,42,35,29,135,
19,27,33,36,115,34,31,36,26,127,
35,28,32,21,9,125,27,37,26,26,15,131,
27,43,19,24,113,35,30,29,29,123,
29,29,28,23,109,27,35,28,30,120,
23,42,28,31,124,31,30,44,29,134,
31,28,38,29,126,27,25,22,27,101,
32,25,29,24,110,32,28,33,27,120,
39,19,28,27,113,15,27,40,35,117,
37,29,25,31,122,21,23,32,25,101,
26,25,38,20,109,31,35,31,30,127,
25,31,24,25,105,26,26,31,33,116,
24,14,32,42,112,38,25,24,31,118,
24,23,33,31,111,38,25,25,29,117,
21,33,24,18,96,38,38,40,17,133,
25,19,30,35,109,26,35,31,26,118,
25,26,24,27,102,38,17,34,31,120,
34,27,24,27,112,24,25,24,27,100,
21,30,25,38,114,36,23,28,19,106,
28,26,37,25,116,23,29,32,23,107,
31,25,33,26,115,26,31,34,18,109,
34,34,32,25,17,142,31,27,39,28,13,138,
26,20,33,27,106,28,19,33,28,108,
37,22,22,24,105,22,25,28,35,110,
19,26,32,33,110,23,31,38,23,115,
26,37,27,26,116,34,40,25,43,142,
26,29,31,20,13,119,28,18,32,28,14,120,
23,33,24,31,111,31,28,36,29,124,
37,20,34,25,116,29,37,34,33,133,
27,33,29,26,115,38,26,24,21,109,
23,34,26,36,119,32,49,27,28,136,
32,24,18,25,99,42,31,22,33,128,
18,11,22,36,87,33,30,34,34,131,
37,35,24,25,121,32,32,25,24,113,
26,23,28,24,101,26,40,20,30,116,
30,30,27,28,115,29,36,29,30,124,
40,36,34,43,11,12,176,40,40,37,36,11,11,175,
22,22,27,24,95,22,22,26,21,91,
16,35,21,31,103,29,25,28,26,108,
27,24,31,39,121,25,27,22,34,108,
26,26,30,24,106,42,31,29,26,128,
20,22,20,32,94,28,38,28,18,112,
28,22,30,30,110,30,26,22,29,107,
33,32,14,23,102,24,31,30,33,118,
26,20,28,27,101,33,20,22,29,104,
29,28,37,33,127,37,27,33,32,129,
27,18,22,15,82,25,22,27,28,102,
16,31,31,33,111,28,33,20,27,108,
28,24,24,17,93,34,30,28,26,118,
36,22,36,30,124,26,24,40,25,115,
34,23,30,17,104,25,34,19,31,109,
31,27,30,26,114,32,41,29,29,131,
22,36,30,32,4,124,35,31,31,23,14,134,
21,25,30,30,106,41,24,27,25,117,
28,30,26,17,101,22,28,30,19,99,
15,31,29,19,94,27,33,28,21,109,
36,14,29,22,101,25,24,25,19,93,
27,25,33,34,119,27,29,34,26,116,
22,30,39,27,118,34,28,23,19,104,
22,27,35,25,109,26,20,47,28,121,
23,23,26,26,98,24,20,26,34,104,
41,33,32,27,133,30,24,30,28,112,
44,27,22,30,123,38,28,21,30,117,
31,38,37,18,124,33,26,39,24,122,
32,18,21,31,102,30,18,25,21,94,
41,24,17,23,105,27,21,39,36,123,
26,32,28,22,108,33,23,19,26,101,
27,30,22,26,105,22,19,32,18,91,
38,31,32,16,117,36,18,32,29,115,
28,24,26,35,113,26,29,41,21,117,
34,37,25,23,119,38,15,24,19,96,
29,28,30,31,118,47,34,29,32,142,
25,22,38,28,113,19,25,24,31,99,
29,37,30,21,117,31,45,32,31,139,
31,26,33,33,123,30,30,24,33,117,
29,24,37,31,121,31,25,35,19,110,
20,30,28,30,108,24,35,30,30,119,
37,30,24,35,126,38,33,39,23,133,
29,25,16,29,99,21,31,31,27,110,
27,29,16,19,91,26,19,42,28,115,
31,33,27,26,117,26,22,25,33,106,
19,30,27,35,111,31,28,38,32,129,
15,40,34,26,115,37,27,20,21,105,
40,20,34,31,125,29,35,21,19,104,
37,34,25,26,122,31,25,32,32,120,
29,23,32,19,103,34,33,30,33,130,
27,31,22,17,97,28,22,30,33,113,
35,22,21,21,99,21,33,28,26,108,
32,31,33,31,127,35,33,33,27,128,
33,23,27,27,110,34,21,21,26,102,
26,27,33,19,11,116,30,23,26,26,4,109,
21,24,22,23,90,24,30,42,18,114,
26,23,26,34,109,29,37,21,30,117,
29,41,25,27,122,32,36,22,20,110,
29,24,32,48,133,29,30,40,31,130,
36,38,31,33,138,30,34,38,32,134,
31,28,37,34,130,25,37,33,31,126,
30,37,28,30,125,35,25,29,33,122,
18,36,18,33,105,33,22,23,35,113,
21,20,21,24,86,36,34,16,16,102,
31,27,34,30,122,27,29,32,31,119,
24,39,24,23,110,38,35,35,34,142,
20,31,33,35,119,35,35,31,28,129,
31,23,34,25,8,10,131,34,27,26,26,8,8,129,
34,25,24,34,117,28,20,32,31,111,
28,33,51,17,129,30,37,30,38,135,
33,35,24,17,5,114,26,30,22,31,9,118,
31,28,30,21,110,18,33,23,30,104,
38,40,36,33,147,39,40,35,29,143,
43,25,28,32,128,30,33,29,38,130,
34,27,27,25,113,29,29,25,35,118,
32,27,20,29,108,29,30,38,26,123,
29,24,36,30,119,26,32,30,29,117,
36,34,32,32,134,26,34,32,31,123,
24,34,29,30,117,27,18,23,26,94,
21,29,37,25,112,21,45,23,16,105,
27,32,33,26,118,32,22,24,18,96,
30,34,35,29,128,40,28,37,32,137,
31,28,27,30,116,34,25,28,33,120,
21,36,23,23,103,23,33,26,30,112,
34,24,32,32,122,28,33,33,26,120,
28,17,27,21,93,35,25,34,21,115,
26,31,30,17,104,30,23,29,18,100,
24,19,22,41,106,24,35,24,30,113,
25,26,36,30,117,29,23,24,20,96,
21,31,28,21,101,34,26,44,28,132,
25,24,25,26,100,17,32,34,25,108,
31,28,34,20,113,23,27,33,20,103,
27,31,33,24,10,125,38,26,34,17,19,134,
29,35,33,34,131,28,28,41,27,124,
28,31,34,17,110,48,29,22,32,131,
20,27,33,33,113,37,27,23,31,118,
23,30,31,33,117,30,39,22,31,122,
37,34,25,23,119,29,27,29,35,120,
24,32,29,29,114,29,21,25,32,107,
26,33,30,26,115,27,23,32,37,119,
26,34,37,17,10,124,33,35,20,26,9,123,
38,29,26,27,120,26,42,30,30,128,
35,27,28,22,112,31,39,15,37,122,
19,30,25,21,95,20,27,29,30,106,
32,26,39,22,119,29,20,32,30,111,
35,34,21,31,121,30,27,33,25,115,
24,31,23,30,6,114,34,24,23,27,18,126,
37,34,30,33,134,38,23,28,36,125,
22,32,33,32,119,32,23,40,16,111,
23,27,33,25,108,27,29,21,35,112,
26,23,28,34,5,116,28,22,30,31,14,125,
32,31,24,23,110,22,22,28,24,96,
31,36,29,32,128,32,27,36,24,119,
30,31,37,24,122,30,39,18,33,120,
25,27,29,33,114,35,24,30,19,108,
19,31,19,24,93,27,28,26,31,112,
25,29,19,37,110,42,32,35,18,127,
29,23,26,24,102,19,28,24,19,90,
31,31,23,27,112,27,32,27,22,108,
20,29,19,29,97,38,29,24,26,117,
40,36,30,30,136,29,23,33,30,115,
29,20,36,19,104,25,25,21,17,88,
26,31,33,25,115,33,23,34,29,119,
29,26,25,29,109,31,31,23,26,111,
21,37,30,24,112,43,32,23,25,123,
27,26,37,43,133,32,30,25,37,124,
30,33,35,22,120,27,21,28,28,104,
20,25,27,25,97,38,23,33,23,117,
30,26,36,18,110,49,23,26,27,125,
39,36,23,25,123,24,16,35,33,108,
33,29,20,25,107,24,28,38,31,121,
29,32,28,25,114,38,29,31,34,132,
29,28,28,31,116,24,24,36,20,104,
20,29,42,32,123,33,22,26,26,107,
29,26,29,34,118,24,36,23,26,109,
27,24,26,42,119,29,34,42,33,138,
25,23,37,32,117,30,28,22,34,114,
19,29,26,36,110,31,31,21,31,114,
23,21,33,27,104,23,20,28,31,102,
28,32,28,33,16,137,29,33,32,27,7,128,
23,35,35,33,126,28,33,38,35,134,
29,29,28,33,119,28,36,22,14,100,
24,30,28,19,101,24,17,30,25,96,
28,31,28,24,111,29,35,29,35,128,
30,25,49,35,139,40,24,37,22,123,
31,27,27,28,113,30,33,31,22,116,
31,35,26,29,121,29,25,13,15,82,
31,35,30,23,119,39,32,33,23,127,
24,20,30,20,94,31,30,23,33,117,
32,27,31,23,10,8,131,28,26,26,33,10,16,139,
26,28,36,22,112,31,18,31,34,114,
26,20,35,28,17,126,35,34,24,16,11,120,
32,31,26,37,126,24,24,22,42,112,
29,33,27,22,111,33,21,26,30,110,
28,39,24,19,110,36,26,29,25,116,
31,26,17,39,113,30,25,27,26,108,
34,38,34,35,141,24,37,34,26,121,
26,32,27,22,107,32,34,28,28,122,
19,26,32,22,99,33,37,20,23,113,
23,36,41,19,119,33,38,33,29,133,
37,34,33,28,132,33,27,32,26,118,
34,30,27,26,117,24,33,31,30,118,
33,30,28,17,108,21,27,23,31,102,
31,38,27,24,120,25,32,33,34,124,
40,43,20,15,118,34,27,39,26,126,
26,26,22,38,112,29,18,34,19,100,
38,26,28,25,117,28,16,34,29,107,
29,27,39,16,111,33,25,31,29,118,
36,23,34,24,117,30,25,28,19,102,
25,24,32,24,105,28,31,25,27,111,
40,26,22,21,109,22,36,27,30,115,
17,27,25,22,8,10,109,22,18,28,23,8,6,105,
42,37,30,31,140,32,38,38,26,134,
26,29,29,37,121,21,29,30,28,108,
28,32,36,12,108,30,27,26,29,112,
19,33,43,25,120,40,28,27,33,128,
25,31,32,24,112,26,34,27,35,122,
32,27,19,29,107,38,28,33,30,129,
23,38,33,21,115,30,25,23,31,109,
16,23,26,19,84,27,37,27,28,119,
30,30,40,32,132,32,22,31,24,109,
23,33,24,21,101,22,29,30,19,100,
31,24,39,24,118,29,28,16,31,104,
30,35,31,31,127,33,30,30,32,125,
32,29,25,34,120,31,33,28,35,127,
36,22,25,35,118,26,26,26,36,114,
36,40,20,20,116,23,25,28,15,91,
34,30,32,29,125,37,38,26,29,130,
28,23,21,22,94,33,33,34,30,130,
40,22,35,27,124,39,28,27,31,125,
29,39,23,36,127,34,22,32,27,115,
26,26,33,26,111,23,36,29,34,122,
22,23,30,31,106,24,29,22,36,111,
31,29,25,31,116,33,28,30,23,114,
24,33,24,15,96,37,25,26,27,115,
29,25,26,25,105,36,18,38,35,127,
32,23,21,19,95,34,26,32,28,120,
26,36,36,26,124,33,33,33,37,136,
26,26,21,24,97,38,34,20,26,118,
30,22,32,30,114,42,41,36,32,151,
37,32,26,22,117,26,29,32,22,109,
40,32,43,29,144,25,33,27,31,116,
27,26,35,24,112,23,32,24,41,120,
26,35,33,30,124,26,19,27,24,96,
30,37,26,34,127,24,32,45,34,135,
25,41,26,19,111,41,33,19,23,116,
35,39,24,32,130,39,33,33,38,143,
28,37,39,25,129,36,33,18,13,100,
38,28,19,21,106,37,26,34,32,129,
24,29,30,22,105,26,32,31,36,125,
26,35,17,35,113,32,23,35,31,121,
37,31,31,32,131,26,30,29,25,110,
16,32,24,32,104,30,25,26,29,110,
29,34,28,27,118,26,29,23,30,108,
34,27,35,27,123,27,29,33,30,119,
32,26,19,16,93,30,38,28,41,137,
22,21,37,11,91,33,27,25,23,108,
25,26,23,32,106,24,36,32,27,119,
21,25,38,20,104,37,26,24,27,114,
25,43,28,22,118,37,25,32,18,112,
29,24,24,22,99,29,26,18,23,96,
31,26,37,32,126,27,24,39,27,117,
29,30,40,28,127,27,20,27,30,104,
33,28,29,25,115,36,30,36,35,137,
37,20,27,33,117,26,26,29,22,103,
18,39,20,34,111,25,36,30,25,116,
34,24,31,35,124,14,21,20,35,90,
34,23,29,33,119,25,33,27,30,115,
32,23,22,35,112,27,35,37,25,124,
23,28,27,33,111,29,35,35,31,130,
24,27,33,34,118,24,35,35,26,120,
23,24,20,25,92,24,29,31,22,106,
15,29,29,35,108,32,27,28,26,113,
26,31,36,44,137,23,45,31,35,134,
36,27,26,20,109,25,21,39,35,120,
34,39,46,30,149,30,39,38,29,136,
25,30,32,27,114,30,24,32,37,123,
23,23,30,16,92,19,29,28,25,101,
37,25,29,17,108,28,29,32,27,116,
31,28,26,36,121,20,31,25,34,110,
29,41,35,36,141,30,34,41,27,132,
26,30,24,26,106,26,28,30,23,107,
36,28,29,35,128,33,29,26,29,117,
24,27,23,26,100,25,23,33,26,107,
19,31,33,37,120,20,26,18,16,80,
34,41,39,26,140,26,21,27,25,99,
21,29,32,25,107,17,23,30,18,88,
31,31,28,31,121,23,23,31,14,91,
32,29,33,23,117,36,29,25,31,121,
30,27,29,24,110,31,46,22,18,117,
24,36,25,31,116,32,31,33,13,109,
29,22,27,36,114,27,30,36,29,122,
33,22,24,28,107,25,34,42,23,124,
42,37,26,25,130,47,25,30,14,116,
28,33,31,23,115,31,27,33,30,121,
34,17,21,22,94,21,34,31,22,108,
27,28,35,33,123,29,36,18,28,111,
26,25,37,27,115,23,31,33,43,130,
36,35,33,34,138,27,32,30,25,114,
20,20,34,19,93,32,28,24,16,100,
31,33,32,26,122,44,32,26,27,129,
31,25,34,24,114,21,34,36,31,122,
35,32,34,27,128,25,27,37,19,108,
17,25,26,42,110,30,23,32,26,111,
36,32,16,23,107,25,28,40,35,128,
31,25,26,25,107,29,33,24,19,105,
29,37,25,32,7,130,37,33,24,29,9,132,
31,30,18,30,109,34,19,33,32,118,
29,15,24,34,102,34,29,28,37,128,
32,31,33,27,19,142,30,28,34,31,11,134,
35,35,31,33,134,21,39,23,26,109,
27,42,29,30,128,27,28,34,29,118,
28,33,26,18,105,28,31,27,29,115,
26,27,29,22,104,41,28,27,21,117,
36,25,26,23,110,26,32,31,23,112,
25,36,33,26,120,29,20,26,25,100,
31,28,21,38,118,27,25,27,26,105,
23,35,35,24,117,29,30,32,22,113,
32,43,39,26,140,29,33,35,31,128,
31,20,26,30,107,24,30,24,24,102,
36,29,25,33,123,26,27,27,25,105,
30,29,26,18,103,31,25,30,38,124,
25,37,33,14,109,41,25,30,23,119,
25,40,31,25,121,22,32,26,23,103,
22,24,21,34,101,28,25,19,31,103,
34,34,29,27,11,135,33,24,36,31,9,133,
39,40,27,19,125,36,33,33,34,136,
25,26,25,18,94,42,27,28,18,115,
47,27,22,27,123,34,23,33,18,108,
38,32,35,33,138,29,38,31,31,129,
32,28,30,26,116,33,34,39,28,134,
28,16,28,21,93,31,25,23,18,97,
21,30,25,16,92,28,21,30,26,105,
34,35,21,34,7,131,32,20,33,39,14,138,
27,44,21,27,119,28,32,32,31,123,
31,21,30,36,118,37,34,22,32,125,
33,34,28,23,118,42,15,16,21,94,
41,26,29,33,129,31,15,32,23,101,
37,24,39,27,127,32,37,29,31,129,
32,23,29,30,114,25,27,24,22,98,
25,30,31,29,115,27,29,33,30,119,
25,30,30,27,112,26,23,24,36,109,
35,38,23,26,122,27,30,30,28,115,
23,28,20,37,108,26,27,36,25,114,
32,21,33,33,17,136,31,32,27,29,12,131,
16,24,33,29,102,34,34,27,26,121,
23,16,23,22,84,27,31,20,23,101,
36,35,37,29,137,31,41,15,27,114,
30,30,23,22,105,27,33,23,30,113,
26,28,31,30,115,29,38,24,21,112,
32,21,33,33,119,16,32,25,24,97,
34,28,27,18,107,30,31,35,25,121,
19,36,40,19,114,32,26,31,29,118,
33,37,26,29,125,26,38,45,27,136,
35,45,39,32,151,35,33,23,40,131,
31,33,26,24,114,29,32,39,20,120,
36,25,39,34,134,21,32,39,13,105,
25,21,18,17,81,26,23,18,36,103,
17,32,21,36,106,25,29,21,20,95,
24,26,35,25,110,23,29,32,39,123,
41,32,27,41,141,45,26,36,29,136,
26,29,24,26,105,35,32,28,26,121,
31,24,32,27,114,39,28,18,24,109,
42,29,37,30,138,14,45,32,26,117,
43,24,14,14,95,26,33,24,26,109,
25,31,39,22,117,31,34,34,29,128,
30,25,30,23,108,18,29,36,30,113,
24,25,24,27,100,20,27,38,30,115,
19,29,34,37,119,28,25,33,28,114,
55,29,34,39,157,27,26,20,28,101,
36,29,26,25,116,27,23,28,27,105,
28,32,26,12,4,102,22,27,30,19,10,108,
23,24,25,37,109,28,30,23,24,105,
32,25,39,27,123,29,34,24,31,118,
21,23,24,23,91,29,20,18,35,102,
23,24,31,17,95,24,33,38,25,120,
25,33,23,20,101,30,37,26,28,121,
19,25,31,24,99,29,45,20,18,112,
30,20,28,23,101,24,21,25,27,97,
29,32,29,33,123,29,26,36,35,126,
32,27,37,32,128,27,38,25,22,112,
33,35,34,28,130,24,31,33,29,117,
30,29,22,34,115,18,36,27,29,110,
23,21,14,22,80,26,29,32,22,109,
25,24,14,21,84,25,19,24,28,96,
23,29,23,31,106,17,41,25,31,114,
25,24,32,25,106,28,33,29,29,119,
22,17,21,30,90,25,34,23,25,107,
29,30,28,22,109,24,35,33,31,123,
19,25,27,22,93,30,29,24,20,103,
28,27,30,37,122,35,46,37,20,138,
22,27,40,24,113,31,33,23,35,122,
32,26,18,26,102,28,19,35,15,97,
20,21,31,25,97,29,24,31,30,114,
27,27,40,35,129,27,24,34,39,124,
37,30,26,29,122,33,41,26,30,130,
17,15,23,24,79,17,28,27,27,99,
28,33,33,26,120,28,27,33,23,111,
22,18,26,30,96,29,19,15,25,88,
23,25,35,29,112,30,17,31,22,100,
21,32,26,20,99,29,37,28,27,121,
9,28,31,33,101,35,18,35,23,111,
23,22,26,22,93,30,24,19,29,102,
32,37,23,33,125,31,34,37,24,126,
35,30,27,37,129,25,28,34,34,121,
22,30,22,22,12,108,23,25,32,16,18,114,
33,24,32,25,114,28,22,28,41,119,
23,29,31,21,7,111,29,25,27,23,13,117,
30,28,24,37,119,27,39,26,25,117,
29,18,30,32,109,22,26,29,35,112,
30,40,24,36,130,32,29,50,25,136,
33,28,26,19,106,26,25,24,20,95,
24,28,24,23,99,38,23,33,22,116,
36,27,23,32,10,128,33,36,33,16,8,126,
33,27,39,24,123,36,20,34,26,116,
35,33,30,30,128,34,33,33,20,120,
23,35,32,28,118,25,26,29,19,99,
20,22,25,18,85,31,28,41,25,125,
32,19,30,26,107,31,37,26,31,125,
21,29,31,27,108,32,23,20,26,101,
30,26,35,29,120,31,27,23,19,100,
31,32,24,32,119,38,28,21,28,115,
21,21,31,14,87,18,22,30,27,97,
29,25,23,28,105,31,20,25,35,111,
29,36,31,21,117,31,33,24,24,112,
22,27,16,22,87,28,29,35,29,121,
33,23,24,20,100,26,41,43,17,127,
28,29,31,26,114,29,21,27,25,102,
31,21,36,26,114,29,38,23,31,121,
21,23,26,16,86,29,29,29,18,105,
30,18,20,29,97,23,36,27,41,127,
19,31,33,24,8,115,27,32,33,15,9,116,
34,27,31,32,124,32,31,35,31,129,
30,18,33,20,101,31,25,34,19,109,
21,31,32,17,101,22,27,28,27,104,
33,25,30,27,115,26,23,23,31,103,
24,25,25,28,102,35,17,39,27,118,
24,23,27,29,103,14,36,34,28,112,
28,31,23,24,106,32,38,23,28,121,
29,21,21,24,95,22,21,30,13,86,
44,37,22,22,125,26,25,25,24,100,
31,19,21,21,92,24,27,23,22,96,
26,20,31,24,101,31,25,35,31,122,
29,23,10,26,88,23,32,33,24,112,
